symbol,allRank,allPoints,d_IndicatorPoints,d_Rank,d_adxPoints,d_allPoints,d_emaPoints,d_kstPoints,d_macdPoints,d_rsiPoints,d_volumePoints,hl_BreakoutPoints,m_IndicatorPoints,m_Rank,m_adxPoints,m_allPoints,m_emaPoints,m_kstPoints,m_macdPoints,m_rsiPoints,m_volumePoints,min75_IndicatorPoints,min75_Rank,min75_adxPoints,min75_allPoints,min75_emaPoints,min75_kstPoints,min75_macdPoints,min75_rsiPoints,min75_volumePoints,w_IndicatorPoints,w_Rank,w_adxPoints,w_allPoints,w_emaPoints,w_kstPoints,w_macdPoints,w_rsiPoints,w_volumePoints
HINDZINC,1,1139,318,225,25,411,62,2,2,9,6,93,98,227,17,191,66,2,2,8,3,420,225,26,513,63,2,2,6,6,210,226,18,303,69,2,2,9,5
EXIDEIND,2,1125,315,1,23,408,63,2,2,9,6,93,105,1,21,198,65,2,2,9,6,404,1,28,497,63,-2,2,9,1,208,2,21,301,69,-2,2,9,5
KSB,3,1121,291,449,16,383,63,2,2,8,6,92,110,449,26,202,65,2,2,9,6,432,449,26,524,63,2,2,9,6,196,451,18,288,69,-2,2,8,3
AEGISCHEM,4,1120,294,35,17,387,63,2,2,8,6,93,97,36,15,190,65,2,2,8,5,432,33,26,525,63,2,2,9,6,204,35,16,297,69,2,2,8,5
BEL,5,1115,300,33,17,393,64,2,2,9,6,93,110,33,26,203,65,2,2,9,6,400,34,24,493,61,2,2,7,4,212,34,21,305,69,2,2,8,4
KEI,6,1094,297,289,17,390,63,2,2,9,6,93,108,289,24,201,65,2,2,9,6,396,289,21,489,63,2,2,7,4,200,291,16,293,69,2,2,8,3
TATAPOWER,7,1092,291,257,16,383,63,2,2,8,6,92,101,258,21,193,65,-2,2,9,6,392,257,24,484,63,2,2,2,5,216,257,23,308,69,2,2,8,4
HEG,8,1090,309,353,21,363,63,2,2,9,6,54,97,355,15,151,65,2,2,8,5,416,353,24,470,64,2,2,8,4,214,354,21,268,69,2,2,8,5
MOTILALOFS,9,1089,300,385,19,390,63,2,2,8,6,90,105,385,21,195,65,2,2,9,6,368,385,20,458,64,-2,2,4,4,226,385,24,316,70,2,2,9,6
ABB,10,1089,300,34,24,393,63,-3,2,8,6,93,110,34,26,203,65,2,2,9,6,368,36,17,461,61,2,2,6,4,218,33,21,311,69,2,2,9,6
VEDL,11,1087,315,419,23,360,63,2,2,9,6,45,85,420,10,130,66,-2,2,8,1,432,417,26,477,63,2,2,9,6,210,420,18,255,69,2,2,9,5
PHOENIXLTD,12,1077,285,481,15,377,63,2,2,8,5,92,108,481,24,200,65,2,2,9,6,396,481,26,488,61,2,2,6,2,196,482,20,288,69,-2,2,8,1
PETRONET,13,1077,300,97,19,392,63,2,2,8,6,92,95,98,14,187,65,2,2,8,4,380,97,21,472,63,2,2,2,5,210,97,19,302,69,2,2,8,5
HINDCOPPER,14,1073,294,66,16,384,63,2,2,9,6,90,85,68,23,175,44,2,2,9,5,388,65,26,478,64,-2,2,4,3,216,66,21,306,70,2,2,9,4
HAL,15,1067,297,323,17,375,64,2,2,8,6,78,112,321,28,190,65,2,2,9,6,364,322,18,442,61,-2,2,8,4,216,321,21,294,70,2,2,9,4
SAIL,16,1065,291,450,16,383,63,2,2,8,6,92,100,451,16,192,65,2,2,9,6,376,450,21,468,61,-2,2,8,4,206,450,17,298,69,2,2,8,5
TORNTPOWER,17,1061,315,65,24,405,63,2,2,8,6,90,110,65,26,200,65,2,2,9,6,316,67,20,406,59,-3,2,0,1,230,65,26,320,70,2,2,9,6
CUMMINSIND,18,1060,276,451,18,366,64,-2,2,5,5,90,110,450,28,200,65,2,2,9,4,368,451,15,458,63,2,2,5,5,216,449,24,306,65,2,2,9,6
DATAPATTNS,19,1060,291,67,16,340,63,2,2,8,6,49,100,70,21,149,65,-2,2,8,6,408,66,24,457,63,2,2,5,6,212,70,19,261,69,2,2,8,6
IRCTC,20,1060,294,5,17,349,63,2,2,8,6,55,101,7,23,156,66,-3,2,8,5,400,3,21,455,63,2,2,7,5,210,6,21,265,69,2,2,8,3
SUNDARMFIN,21,1058,294,3,17,385,63,2,2,8,6,91,105,2,21,196,65,2,2,9,6,352,4,23,443,63,-2,2,3,-1,216,1,24,307,69,2,2,8,3
EICHERMOT,22,1058,297,2,19,389,63,2,2,8,5,92,95,4,15,187,65,2,2,8,3,376,2,21,468,63,1,2,2,5,198,3,13,290,70,2,2,8,4
MAHLIFE,23,1057,300,321,19,390,63,2,2,8,6,90,99,322,21,189,65,-3,2,8,6,368,321,16,458,61,2,2,7,4,200,323,15,290,69,2,2,8,4
THERMAX,24,1055,318,226,24,405,63,2,2,9,6,87,110,225,26,197,65,2,2,9,6,320,229,19,407,59,-3,3,2,0,220,225,23,307,69,2,2,9,5
JUBLINGREA,25,1049,297,230,17,341,63,2,2,9,6,44,90,231,13,134,66,-2,2,6,5,420,226,24,464,64,2,2,7,6,198,231,14,242,69,2,2,7,5
GODREJPROP,26,1039,306,161,21,396,63,2,2,8,6,90,101,163,19,191,65,2,2,8,5,324,162,21,414,59,-3,2,1,1,218,162,23,308,69,2,2,8,5
MCDOWELL-N,27,1034,273,194,13,365,63,2,2,5,6,92,101,194,18,193,65,2,2,8,6,368,193,16,460,63,2,2,4,5,200,194,18,292,70,-2,2,8,4
GLENMARK,28,1027,294,228,16,369,63,2,2,9,6,75,102,228,19,177,65,2,2,9,5,352,228,21,427,61,-3,2,3,4,204,228,16,279,69,2,2,9,4
360ONE,29,1024,291,357,16,306,63,2,2,8,6,15,106,357,24,121,65,2,2,8,5,408,354,24,423,63,2,2,7,4,204,357,21,219,69,-2,2,8,4
ANANDRATHI,30,1019,282,231,16,329,64,2,2,7,3,47,108,230,28,155,65,-2,2,9,6,388,227,21,435,63,2,2,8,1,194,232,24,241,65,-3,2,6,3
INDIGO,31,1018,303,290,21,380,64,2,2,7,5,77,104,291,21,181,65,2,2,9,5,316,293,24,393,55,2,2,-2,-2,218,290,21,295,69,2,2,9,6
DIXON,32,1015,303,322,19,375,64,2,2,8,6,72,106,323,23,178,65,2,2,8,6,316,324,18,388,55,2,2,-1,3,218,322,21,290,69,2,2,9,6
JBCHEPHARM,33,1013,294,8,16,309,63,2,2,9,6,15,104,10,24,119,65,-2,2,9,6,404,6,19,419,63,2,2,9,6,196,11,17,211,69,-2,2,8,4
DMART,34,1012,309,387,21,363,63,2,2,9,6,54,89,390,13,143,65,-2,2,8,3,344,386,19,398,61,-3,2,3,4,216,388,21,270,69,2,2,9,5
JSWENERGY,35,1008,291,259,17,381,63,2,2,8,5,90,99,259,21,189,65,-3,2,9,5,312,261,21,402,55,-3,2,-1,4,216,258,21,306,69,2,2,9,5
MAXHEALTH,36,1008,294,266,17,309,63,2,2,8,6,15,105,265,26,120,65,-2,2,9,5,400,259,21,415,63,2,2,7,5,194,268,16,209,69,2,2,8,0
MUTHOOTFIN,37,1007,312,98,24,361,63,2,2,7,6,49,98,101,17,147,65,2,2,8,4,344,98,19,393,61,-3,2,4,3,204,101,17,253,69,2,2,8,4
ASTERDM,38,1005,285,421,17,298,63,2,2,8,3,13,103,423,19,116,65,2,2,9,6,400,420,26,413,63,-3,2,8,4,204,421,24,217,69,-2,2,5,4
NUVAMA,39,1005,309,263,21,345,63,2,2,9,6,36,86,263,18,122,65,-2,2,1,2,396,258,20,432,63,2,2,8,4,178,265,17,214,59,-2,2,9,4
KPIL,40,1005,288,163,20,375,63,2,2,4,5,87,106,162,23,193,64,2,2,9,6,300,165,19,387,55,-3,2,-2,4,224,161,24,311,69,2,2,9,6
CASTROLIND,41,1003,285,130,15,360,63,2,2,7,6,75,101,133,19,176,65,2,2,8,5,328,131,19,403,59,-3,2,1,4,214,131,21,289,69,2,2,8,5
VTL,42,1000,288,167,15,330,63,2,2,8,6,42,92,167,10,134,65,2,2,8,5,384,161,17,426,63,2,2,8,4,194,167,11,236,69,2,2,8,5
TATAMOTORS,43,1000,264,131,13,349,63,-3,2,7,6,85,107,129,23,192,65,2,2,9,6,332,130,16,417,61,1,2,2,1,212,129,26,297,65,2,2,6,5
GAIL,44,997,285,417,16,374,63,2,2,7,5,89,105,417,21,194,65,2,2,9,6,296,422,19,385,55,-3,0,0,3,222,417,24,311,69,2,2,9,5
BAJAJ-AUTO,45,994,255,6,18,334,62,-3,2,3,3,79,106,5,23,185,64,2,2,9,6,348,5,12,427,63,2,2,4,4,206,4,24,285,66,2,2,4,5
GPIL,46,993,291,483,16,305,63,2,2,8,6,14,94,486,21,108,59,-3,2,9,6,396,482,21,410,63,2,2,5,6,198,485,19,212,69,-3,2,8,4
IPCALAB,47,992,291,324,16,345,63,2,2,8,6,54,101,324,19,155,65,2,2,8,5,340,323,20,394,59,-2,2,1,5,206,324,20,260,69,-2,2,8,6
CDSL,48,991,276,299,14,291,63,2,2,8,3,15,100,296,21,115,66,-2,2,8,5,412,290,21,427,63,2,2,9,6,188,298,19,203,69,-3,2,4,3
BHEL,49,989,285,418,13,372,64,2,2,8,6,87,87,419,23,174,45,2,2,9,6,332,419,16,419,59,2,2,0,4,198,418,21,285,69,-3,2,5,5
AARTIIND,50,988,294,420,17,339,63,2,2,8,6,45,77,421,16,122,45,2,2,7,5,404,418,19,449,63,2,2,9,6,168,422,19,213,48,2,2,8,5
BSE,51,983,297,260,19,371,63,2,2,7,6,74,110,260,26,184,65,2,2,9,6,296,262,18,370,55,-3,2,-1,3,206,262,21,280,70,-3,2,8,5
BRIGADE,52,982,288,395,16,298,63,2,2,7,6,10,108,393,24,118,65,2,2,9,6,380,387,21,390,63,2,2,4,3,196,393,20,206,69,-3,2,5,5
RADICO,53,979,288,198,16,303,63,2,2,8,5,15,98,199,21,113,65,-2,2,8,4,380,195,17,395,63,2,2,7,4,198,198,18,213,69,-2,2,8,4
VGUARD,54,978,276,129,12,363,63,2,2,7,6,87,97,130,15,184,65,2,2,8,5,312,132,21,399,55,-3,2,-1,4,206,130,15,293,70,2,2,8,6
"ARE&M",55,974,294,199,17,301,63,2,2,8,6,7,93,204,18,100,64,2,2,7,0,388,194,26,395,63,-3,2,5,4,192,202,17,199,69,-2,2,7,3
NTPC,56,971,294,258,17,381,63,2,2,8,6,87,110,257,26,197,65,2,2,9,6,276,264,21,363,55,-3,0,-2,-2,204,259,24,291,69,-3,2,5,5
"M&M",57,970,291,227,18,381,63,2,2,7,5,90,105,226,21,195,65,2,2,9,6,276,230,18,366,55,-3,0,0,-1,208,227,19,298,69,2,2,8,4
BLUESTARCO,58,968,288,291,19,376,64,2,2,4,5,88,110,290,26,198,65,2,2,9,6,260,297,18,348,47,-3,0,-2,5,222,289,24,310,69,2,2,8,6
NAM-INDIA,59,968,294,196,17,308,63,2,2,8,6,14,102,197,19,116,65,2,2,8,6,352,197,24,366,59,-3,2,1,5,206,197,24,220,69,-2,2,5,5
HONAUT,60,965,303,293,19,348,63,2,2,9,6,45,85,295,10,130,66,-2,2,6,3,348,292,23,393,59,-3,2,1,5,184,295,14,229,61,2,2,8,5
QUESS,61,961,309,36,21,354,63,2,2,9,6,45,17,57,6,62,-4,2,3,6,4,424,35,26,469,63,2,2,8,5,166,37,17,211,48,2,2,9,5
INOXWIND,62,959,279,484,15,283,63,2,2,5,6,4,90,492,26,94,45,2,2,9,6,396,483,21,400,63,2,2,7,4,190,488,19,194,69,-3,2,5,3
VIJAYA,63,958,282,170,13,297,63,2,2,8,6,15,69,184,16,84,38,2,2,7,4,384,164,15,399,63,2,2,8,6,208,168,23,223,69,-3,2,8,5
CENTURYTEX,64,954,291,162,17,381,63,2,2,7,6,90,105,161,21,195,65,2,2,9,6,252,170,18,342,49,-3,0,-2,1,216,163,21,306,69,2,2,8,6
TRENT,65,951,264,172,15,273,63,-2,2,7,3,9,112,168,28,121,65,2,2,9,6,368,167,17,377,63,2,2,7,1,198,170,24,207,65,-3,2,6,5
VOLTAS,66,950,297,354,19,339,63,2,2,7,6,42,97,356,16,139,65,2,2,8,4,292,356,20,334,55,-3,0,0,1,222,355,23,264,69,2,2,9,6
PNB,67,945,285,261,15,359,64,2,2,6,6,74,86,262,23,160,44,2,2,9,6,292,263,16,366,55,-3,2,-2,5,208,260,24,282,66,2,2,5,5
JINDALSAW,68,944,285,168,15,297,63,2,2,7,6,12,97,171,24,109,59,2,2,4,6,364,168,16,376,61,2,2,6,4,186,173,16,198,70,-3,2,4,4
EIDPARRY,69,938,282,422,15,289,63,2,2,7,5,7,89,430,14,96,65,-3,2,5,6,372,423,18,379,63,1,2,4,5,188,426,17,195,69,-3,2,6,3
JIOFIN,70,938,276,69,19,301,61,-3,2,8,5,25,85,72,18,110,64,-2,2,1,2,352,68,21,377,61,-3,2,2,5,200,71,26,225,55,2,2,9,6
NMDC,71,937,291,298,16,300,63,2,2,8,6,9,81,308,19,90,44,2,2,9,5,368,295,21,377,61,2,2,1,5,188,299,21,197,69,-3,2,5,0
CHALET,72,937,294,201,18,297,63,2,2,7,6,3,108,201,24,111,65,2,2,9,6,328,199,9,331,63,2,2,4,2,204,199,24,207,70,-3,2,4,5
INDUSTOWER,73,935,300,262,19,352,63,2,2,8,6,52,51,270,16,103,17,2,2,8,6,356,260,21,408,61,-2,2,4,3,176,264,21,228,49,2,2,9,5
COCHINSHIP,74,933,291,482,17,361,63,2,2,7,6,70,110,482,26,180,65,2,2,9,6,244,484,20,314,47,-3,0,-2,-1,218,481,26,288,69,-3,2,9,6
ICICIPRULI,75,930,300,292,18,349,64,2,2,8,6,49,91,294,9,140,66,2,2,7,5,292,298,18,341,55,-3,2,-2,3,198,294,14,247,69,2,2,8,4
HINDALCO,76,926,291,134,16,305,63,2,2,8,6,14,89,142,16,103,65,-3,2,6,3,344,134,21,358,59,2,2,0,2,188,138,17,202,70,-3,2,7,1
TATAMTRDVR,77,922,261,166,13,343,63,-3,2,6,6,82,109,164,25,191,65,2,2,9,6,272,169,15,354,55,-3,2,-1,0,198,166,24,280,66,-3,2,5,5
POONAWALLA,78,922,261,140,11,270,63,2,2,5,4,9,98,136,21,107,65,-3,2,8,5,344,135,16,353,61,-3,2,6,4,210,135,20,219,69,2,2,7,5
LLOYDSME,79,918,294,453,17,329,63,2,2,8,6,35,17,476,16,52,-3,-2,3,1,2,396,452,24,431,63,2,2,2,6,176,454,13,211,59,2,2,8,4
MCX,80,918,288,169,16,297,63,2,2,7,6,9,103,170,19,112,65,2,2,9,6,324,171,21,333,55,1,2,-2,4,194,172,19,203,70,-3,2,5,4
ZOMATO,81,917,294,229,19,345,63,2,2,7,5,51,74,232,19,125,36,2,2,9,6,280,233,16,331,55,-3,0,-1,3,218,229,21,269,70,2,2,9,5
CONCORDBIO,82,916,297,295,19,310,63,2,2,7,6,13,86,301,18,99,65,-2,2,1,2,340,296,19,353,61,2,2,-1,2,180,301,23,193,59,-3,2,5,4
BEML,83,916,285,135,16,296,63,2,2,6,6,11,102,134,19,113,65,2,2,8,6,324,136,24,335,55,-3,2,-1,4,194,137,21,205,69,-3,2,4,4
CESC,84,915,297,297,19,308,63,2,2,7,6,11,99,297,17,110,65,2,2,8,5,312,300,23,323,55,-3,2,0,1,196,296,19,207,69,-3,2,8,3
"M&MFIN",85,915,291,101,16,318,63,2,2,8,6,27,89,103,14,116,65,-3,2,7,4,332,100,23,359,59,-3,2,1,1,176,103,5,203,69,2,2,6,4
SIEMENS,86,913,294,193,21,379,63,1,2,5,6,85,110,193,26,195,65,2,2,9,6,196,204,14,281,47,-3,-2,-3,-4,228,193,26,313,69,2,2,9,6
KARURVYSYA,87,913,279,171,14,288,63,2,2,6,6,9,107,169,24,116,65,2,2,9,5,320,173,18,329,61,-3,0,1,3,198,169,23,207,69,-3,2,4,4
COALINDIA,88,912,246,174,4,255,63,2,2,6,5,9,89,176,26,98,44,2,2,9,6,372,166,16,381,63,2,2,4,6,196,171,24,205,66,-3,2,5,4
ICICIBANK,89,911,237,133,6,317,63,-2,2,6,4,80,96,132,18,176,66,-3,2,8,5,296,133,14,376,61,-3,0,2,0,202,132,18,282,66,2,2,8,5
MANAPPURAM,90,910,291,389,16,335,63,2,2,8,6,44,91,391,11,135,65,2,2,7,4,288,392,21,332,55,-3,2,-1,-2,196,391,16,240,69,-2,2,8,5
METROPOLIS,91,909,291,132,16,336,63,2,2,8,6,45,41,153,3,86,25,2,3,6,2,384,129,23,429,63,2,2,2,4,148,143,14,193,49,-2,2,7,4
BHARTIARTL,92,900,186,424,-4,266,61,-2,2,2,3,80,106,418,21,186,66,2,2,9,6,328,421,14,408,63,2,2,3,-2,200,419,24,280,65,1,2,4,4
SRF,93,886,276,233,13,308,63,2,2,7,5,32,88,233,15,120,66,-3,2,7,1,292,234,16,324,55,2,2,-2,0,198,233,13,230,69,2,2,8,5
DOMS,94,884,288,392,19,310,63,2,2,4,6,22,86,395,18,108,65,-2,2,1,2,316,391,20,338,55,-3,2,0,5,172,398,15,194,59,-2,2,8,4
NSLNISP,95,875,282,104,15,291,63,2,2,6,6,9,94,106,19,103,65,-2,2,4,6,324,103,21,333,59,-3,2,-1,3,166,110,16,175,59,-2,2,7,1
JUSTDIAL,96,874,285,454,17,290,63,2,2,5,6,5,96,459,15,101,65,2,2,6,6,276,454,19,281,49,-3,2,-1,3,212,453,19,217,70,2,2,7,6
ABCAPITAL,97,874,291,386,17,363,63,2,2,7,6,72,75,389,18,147,45,-2,2,8,4,244,394,18,316,49,-3,2,-1,-4,192,389,12,264,69,2,2,7,4
CAMS,98,869,246,330,6,251,63,2,2,5,4,5,96,327,14,101,65,2,2,7,6,336,325,16,341,59,2,2,2,3,186,327,18,191,69,-3,2,3,4
SCHAEFFLER,99,868,288,197,17,306,63,2,2,8,4,18,96,198,24,114,66,-3,2,4,3,288,201,9,306,61,-3,2,0,3,178,204,9,196,69,2,2,6,1
IRB,100,866,288,10,16,298,64,2,2,6,6,10,110,9,26,120,65,2,2,9,6,256,13,24,266,47,-3,0,-2,-2,202,10,19,212,69,-3,2,8,6
BAJAJFINSV,101,864,282,325,15,300,63,2,2,7,5,18,82,328,8,100,65,-3,2,6,4,296,329,18,314,55,-3,2,-1,3,186,325,11,204,69,2,2,6,3
ELGIEQUIP,102,863,228,50,13,235,49,2,2,4,6,7,98,41,20,105,65,-3,2,8,6,344,37,12,351,63,2,2,3,4,186,41,18,193,65,2,2,2,4
USHAMART,103,862,288,200,16,297,63,2,2,7,6,9,89,206,23,98,60,-3,2,3,4,300,200,7,309,61,-2,2,2,5,176,205,8,185,70,-2,2,6,4
MAZDOCK,104,862,261,173,16,270,55,2,2,6,6,9,98,172,26,107,59,1,2,4,6,308,174,23,317,55,-3,0,-1,3,186,174,18,195,67,-3,2,6,3
POLYCAB,105,861,291,393,16,307,63,2,2,8,6,16,90,398,24,106,59,-3,2,4,4,288,395,13,304,59,-2,2,-1,1,176,399,11,192,70,-2,2,7,0
UBL,106,859,276,423,14,288,63,2,2,8,3,12,91,425,15,103,65,-3,2,7,5,292,425,11,304,59,-2,2,0,3,188,423,14,200,69,-2,2,7,4
BDL,107,859,237,48,3,237,63,2,2,4,5,0,108,38,24,108,65,2,2,9,6,336,39,16,336,59,2,2,2,3,178,48,18,178,65,-3,2,3,4
LICHSGFIN,108,857,288,103,17,292,63,2,2,7,5,4,99,105,16,103,65,2,2,8,6,268,106,16,272,55,-3,2,-1,-2,198,104,21,202,69,-3,2,5,5
TATACHEM,109,853,267,394,16,301,63,-2,2,5,5,34,96,392,19,130,66,-3,2,7,5,260,397,18,294,55,-3,0,-2,-3,196,392,16,230,69,2,2,5,4
UTIAMC,110,852,270,269,14,279,63,2,2,7,2,9,85,275,11,94,65,-3,2,5,5,288,268,13,297,61,-3,2,2,-3,200,267,19,209,69,-2,2,7,5
DEEPAKNTR,111,851,189,178,16,204,29,2,2,8,6,15,87,173,15,102,66,-3,2,2,5,396,163,19,411,63,2,2,8,5,164,176,7,179,67,-3,2,6,3
MEDANTA,112,845,282,234,15,289,64,2,2,6,5,7,100,235,24,107,64,-2,2,6,6,268,237,16,275,55,-3,2,0,-3,188,236,24,195,60,-2,2,5,5
CIEINDIA,113,845,261,71,15,273,55,2,2,8,5,12,84,76,20,96,59,-3,2,3,3,352,69,15,364,61,-2,2,7,5,136,79,10,148,53,-2,3,6,-2
GRAPHITE,114,842,261,9,16,307,61,2,2,0,6,46,99,8,16,145,65,2,2,8,6,220,14,21,266,39,-3,0,-5,3,216,7,23,262,69,2,2,8,4
FDC,115,841,240,398,3,242,63,2,2,5,5,2,101,400,18,103,65,2,2,8,6,300,396,14,302,61,-3,0,2,1,198,395,23,200,69,-3,2,3,5
GODREJIND,116,839,279,136,16,288,63,2,2,4,6,9,103,135,21,112,65,2,2,7,6,252,140,20,261,47,-3,0,-1,0,196,136,21,205,69,-3,2,5,4
REDINGTON,117,832,264,264,13,344,63,2,2,3,5,80,96,261,19,176,66,-3,2,8,4,192,270,13,272,39,-3,0,-4,3,200,261,18,280,65,2,2,8,5
RRKABEL,118,832,279,102,14,297,63,2,2,7,5,18,81,109,13,99,65,-2,2,1,2,300,104,7,318,61,2,2,2,1,154,114,9,172,60,-2,2,8,0
WELCORP,119,828,270,455,15,279,63,2,2,3,5,9,101,454,24,110,59,2,2,8,6,268,455,11,277,59,-3,2,1,-3,180,461,16,189,70,-3,2,2,3
KALYANKJIL,120,827,285,355,15,337,64,2,2,6,6,52,108,354,24,160,65,2,2,9,6,180,361,-11,232,47,2,3,4,0,202,356,23,254,70,-3,2,5,4
LODHA,121,824,255,425,9,261,63,2,2,5,4,6,105,424,21,111,65,2,2,9,6,268,427,18,274,49,-2,0,-1,3,190,425,18,196,69,-3,2,4,5
SOBHA,122,823,285,40,16,291,64,2,2,6,5,6,102,37,19,108,64,2,2,9,6,228,47,16,234,49,-3,0,-2,-3,202,38,23,208,69,-3,2,5,5
INDHOTEL,123,822,204,70,-7,292,64,-2,2,6,5,88,110,66,26,198,65,2,2,9,6,212,72,-15,300,61,2,2,5,-2,208,67,21,296,65,2,2,9,5
NLCINDIA,124,822,252,45,8,252,63,2,2,4,5,0,98,44,24,98,59,2,2,8,3,288,44,18,288,55,-2,2,-2,1,184,45,18,184,70,-3,2,4,1
PNCINFRA,125,821,270,238,16,268,63,2,2,3,4,-2,101,239,18,99,66,2,2,8,5,256,239,15,254,47,-3,3,1,1,196,237,16,194,65,2,2,8,5
MSUMI,126,821,273,137,13,278,63,2,2,5,6,5,91,146,13,96,65,-2,2,8,5,264,138,12,269,45,-3,3,5,4,188,144,11,193,70,2,2,5,4
MOTHERSON,127,817,264,327,13,269,63,2,2,5,3,5,58,342,13,63,31,2,2,7,3,332,326,13,337,61,2,2,2,3,158,336,16,163,45,2,2,8,6
LUPIN,128,816,201,403,8,201,47,-2,3,5,6,0,99,402,21,99,59,2,2,9,6,320,393,15,320,61,2,2,2,-2,196,397,24,196,66,-3,2,4,5
IDFC,129,813,210,399,17,230,35,2,2,8,6,20,87,396,21,107,59,-3,2,4,4,352,389,21,372,61,-2,2,1,5,144,405,13,164,54,-2,3,6,-2
JINDALSTEL,130,802,273,388,15,358,64,2,2,4,4,85,102,386,19,187,65,2,2,9,5,132,400,-5,217,47,-3,1,-3,-4,210,386,19,295,69,2,2,8,5
SYNGENE,131,801,210,400,17,225,35,2,2,8,6,15,82,404,16,97,59,-2,2,2,5,364,388,19,379,63,2,2,0,5,130,407,6,145,45,2,3,6,3
NBCC,132,801,270,139,15,271,63,2,2,3,5,1,104,138,21,105,64,2,2,9,6,232,143,16,233,47,-3,0,-2,0,194,142,24,195,65,-3,2,3,6
NATIONALUM,133,800,285,164,17,371,63,2,2,5,6,86,103,165,19,189,65,2,2,9,6,116,177,-8,202,47,-3,0,-4,-3,210,164,19,296,69,2,2,8,5
GLS,134,795,258,13,10,256,63,2,2,3,6,-2,73,23,20,71,38,2,2,6,5,280,12,14,278,55,-3,0,1,3,186,15,20,184,65,-2,2,3,5
ASHOKLEY,135,795,261,12,15,272,55,2,2,7,6,11,75,17,14,86,59,-3,2,3,0,312,8,14,323,61,-2,2,0,3,136,19,6,147,55,-2,3,6,0
FORTIS,136,788,258,73,13,264,63,2,2,3,3,6,96,75,21,102,60,2,2,8,3,248,73,18,254,47,-3,0,-3,3,180,75,19,186,69,-3,2,3,0
FEDERALBNK,137,784,246,240,6,250,63,2,2,5,4,4,92,242,16,96,65,-3,2,8,4,260,238,9,264,55,-3,2,-1,3,182,238,13,186,70,-3,2,6,3
GRSE,138,784,276,41,15,283,63,2,2,4,6,7,93,43,21,100,59,1,2,4,6,220,48,18,227,47,-3,0,-4,-3,188,39,14,195,70,-3,2,6,5
BORORENEW,139,779,222,17,4,226,57,2,2,4,5,4,81,18,13,85,65,-3,2,4,0,284,11,9,288,55,2,2,-1,4,188,14,11,192,69,2,2,5,5
CANBK,140,772,270,4,13,351,64,2,2,4,5,81,109,3,26,190,64,2,2,9,6,116,19,-7,197,39,-3,0,-4,4,196,5,19,277,66,2,2,4,5
IDFCFIRSTB,141,770,180,306,17,194,29,2,2,7,3,14,84,302,18,98,60,-3,2,3,4,376,294,19,390,63,2,2,2,6,116,312,10,130,43,-2,1,5,1
GUJGASLTD,142,768,210,303,-6,217,63,2,2,4,5,7,87,305,12,94,66,-2,2,6,3,276,302,7,283,61,-3,0,1,3,188,300,15,195,64,2,2,6,5
CSBBANK,143,767,252,329,14,261,55,2,2,6,5,9,90,329,16,99,59,2,2,6,5,244,332,18,253,47,-3,0,-4,3,172,331,13,181,70,-3,2,3,1
CONCOR,144,767,273,268,13,282,63,2,2,5,6,9,97,268,16,106,65,2,2,7,5,204,272,-7,213,55,-3,2,-1,5,184,270,16,193,69,-3,2,4,4
RITES,145,764,198,362,4,203,49,2,2,4,5,5,103,358,21,108,65,2,2,7,6,276,357,11,281,47,2,2,4,3,182,360,20,187,65,-3,2,2,5
CENTRALBK,146,757,246,486,8,250,63,2,2,2,5,4,87,493,26,91,44,2,2,8,5,232,486,14,236,47,-3,0,-3,3,188,489,21,192,66,-3,2,3,5
JAIBALAJI,147,757,204,401,10,211,43,2,3,6,4,7,98,399,26,105,58,2,2,4,6,264,399,18,271,43,-3,2,3,3,184,400,21,191,66,-3,2,3,3
RAYMOND,148,753,273,42,14,281,63,2,2,4,6,8,94,42,21,102,65,-3,2,5,4,204,49,16,212,39,-3,0,-4,3,174,47,3,182,70,2,2,6,4
ESCORTS,149,752,267,236,18,276,55,2,2,6,6,9,86,244,20,95,59,-3,2,4,4,240,240,13,249,49,-3,0,-2,3,150,246,12,159,54,-3,3,6,3
NAUKRI,150,750,282,390,17,331,63,2,2,5,5,49,99,388,17,148,65,2,2,8,5,112,401,-13,161,47,-3,0,-3,0,208,390,19,257,69,2,2,8,4
HFCL,151,740,180,243,4,187,43,2,2,5,4,7,93,238,16,100,66,-3,2,6,6,284,236,16,291,41,2,2,5,5,176,240,18,183,65,-3,2,2,4
SBIN,152,738,240,427,10,244,63,2,2,0,3,4,96,426,19,100,65,-3,2,8,5,204,432,7,208,49,-3,2,-4,0,194,424,17,198,65,2,2,7,4
FLUOROCHEM,153,738,150,112,18,160,15,2,2,8,5,10,84,111,13,94,66,-3,2,2,4,332,102,21,342,43,2,2,9,6,162,112,6,172,67,-2,3,6,1
DIVISLAB,154,737,261,300,17,271,55,2,2,6,5,10,62,315,3,72,52,-3,2,4,4,268,303,16,278,55,-3,2,-1,-2,136,308,5,146,53,-2,3,6,3
SONACOMS,155,735,231,176,11,234,59,-3,1,5,4,3,85,181,10,88,59,2,2,6,6,260,176,16,263,35,2,2,6,4,156,180,7,159,65,1,2,2,1
POLICYBZR,156,735,276,7,19,322,63,2,2,1,5,46,41,14,17,87,11,-2,2,7,6,196,15,18,242,39,-3,0,-2,-3,176,9,21,222,49,2,2,9,5
COROMANDEL,157,734,261,270,16,276,55,2,2,6,6,15,80,273,14,95,59,-2,2,3,4,252,271,16,267,49,-3,0,-2,3,126,278,6,141,53,-2,3,6,-3
SAPPHIRE,158,734,249,141,11,265,63,-2,2,6,3,16,85,144,8,101,65,-2,2,7,5,204,145,10,220,29,2,2,7,1,180,139,7,196,69,2,2,6,4
FSL,159,734,201,144,-10,204,63,2,2,5,5,3,96,145,18,99,60,2,2,8,6,244,141,13,247,49,-2,2,-2,1,190,145,18,193,69,-3,2,4,5
TATASTEEL,160,732,279,165,16,363,64,2,2,4,5,84,95,166,17,179,65,-2,2,8,5,64,180,-10,148,39,-3,-2,-4,-4,210,165,19,294,69,2,2,8,5
CUB,161,731,297,265,19,312,63,2,2,7,6,15,29,284,3,44,17,-2,3,5,3,292,266,20,307,55,-3,0,-2,3,98,280,6,113,31,2,2,7,1
ACI,162,728,138,52,7,148,23,2,3,6,5,10,88,45,15,98,65,-2,2,5,3,332,38,21,342,43,2,2,9,6,160,49,12,170,59,-2,2,5,4
MFSL,163,726,270,202,11,285,63,2,2,6,6,15,97,200,16,112,65,2,2,7,5,156,206,-12,171,49,1,2,-2,1,188,200,13,203,70,-2,2,7,4
POWERINDIA,164,723,282,100,21,337,63,2,2,1,5,55,110,100,26,165,65,2,2,9,6,60,110,-13,115,39,-3,0,-5,-3,216,99,21,271,69,2,2,9,5
NHPC,165,723,237,108,3,241,63,2,2,3,6,4,110,104,26,114,65,2,2,9,6,188,109,10,192,39,-2,0,-4,4,184,107,21,188,66,-2,2,4,1
CELLO,166,720,159,111,8,168,29,2,2,7,5,9,56,123,-11,65,65,-2,2,0,2,348,101,13,357,63,-3,2,6,6,148,115,8,157,57,-2,1,6,4
DELHIVERY,167,711,243,16,5,246,63,2,2,6,3,3,-23,30,8,-20,-38,-2,3,2,4,344,7,16,347,63,2,2,3,0,144,18,13,147,45,2,2,5,5
TATACONSUM,168,707,135,405,-10,144,41,2,3,5,4,9,103,394,21,112,66,2,2,7,5,280,398,16,289,43,2,2,4,3,180,401,20,189,65,-3,2,2,4
MMTC,169,705,243,15,13,247,57,2,2,2,5,4,50,24,21,54,13,2,2,6,6,212,16,14,216,47,-3,0,-3,-2,196,13,21,200,70,-3,2,2,6
EIHOTEL,170,704,273,235,18,282,63,2,2,1,5,9,106,234,23,115,64,2,2,9,6,96,246,-8,105,39,-2,0,-5,0,220,234,26,229,65,2,2,9,6
AVANTIFEED,171,703,240,46,3,244,63,2,2,4,6,4,85,49,10,89,59,2,2,6,6,184,51,13,188,39,-3,0,-4,1,190,40,18,194,65,2,2,2,6
APOLLOHOSP,172,702,228,489,8,227,61,2,2,2,1,-1,99,489,21,98,66,-3,2,8,5,196,487,7,195,47,-3,0,-3,1,180,491,18,179,65,-3,2,3,5
ENDURANCE,173,698,246,273,10,252,61,2,2,2,5,6,90,272,19,96,59,1,2,5,4,184,274,18,190,39,-3,0,-4,-4,172,275,16,178,70,-3,2,1,0
TATAINVEST,174,696,144,114,12,148,36,-3,3,-1,1,4,112,102,28,116,65,2,2,9,6,236,108,10,240,45,-3,3,1,3,200,102,23,204,65,2,2,2,6
BAJFINANCE,175,689,228,301,16,234,43,2,2,7,6,6,69,313,9,75,59,-3,2,2,0,284,301,11,290,59,2,2,-1,-2,102,314,6,108,37,2,3,5,-2
WESTLIFE,176,688,144,113,16,154,15,2,2,7,6,10,82,112,16,92,60,-3,2,2,5,380,99,16,390,63,2,2,7,5,72,123,-10,82,37,-2,3,5,3
GMDCLTD,177,684,171,334,14,180,29,2,2,5,5,9,94,325,21,103,59,2,2,4,6,244,331,18,253,39,-3,2,0,5,166,332,11,175,68,-3,3,3,1
MGL,178,684,261,239,15,256,61,2,2,2,5,-5,98,246,17,93,65,2,2,7,5,140,245,-7,135,47,-3,0,-3,1,190,239,16,185,69,2,2,3,3
GPPL,179,684,219,75,6,219,64,-3,2,0,4,0,105,73,21,105,65,2,2,9,6,160,76,15,160,25,2,1,-4,1,200,72,18,200,65,2,2,7,6
RAINBOW,180,682,273,138,18,277,63,2,2,3,3,4,99,141,23,103,65,-2,2,6,5,88,148,7,92,25,-2,-2,-4,-2,218,134,24,222,69,2,2,7,5
LTTS,181,678,267,271,16,276,61,2,2,3,5,9,96,269,18,105,66,-3,2,8,5,112,277,-7,121,39,-3,3,-1,-3,194,269,20,203,69,-2,2,4,4
LEMONTREE,182,678,189,51,-7,193,63,2,2,2,1,4,101,39,20,105,65,1,2,8,5,204,50,14,208,39,-3,1,-1,1,180,46,14,184,69,-3,2,3,5
ZENSARTECH,183,674,243,175,18,249,59,-3,2,0,5,6,95,175,19,101,59,2,2,8,5,148,179,4,154,31,-2,3,-3,4,182,175,18,188,69,-3,2,2,3
GSPL,184,671,270,456,14,273,63,2,2,3,6,3,98,458,16,101,65,2,2,8,5,96,465,-13,99,39,-3,0,-4,5,204,455,18,207,69,2,2,7,4
EQUITASBNK,185,671,168,430,11,178,29,2,2,7,5,10,87,429,20,97,59,-3,2,4,5,248,428,16,258,41,-2,2,0,5,158,433,13,168,68,-3,1,2,-2
DLF,186,671,255,74,15,258,63,2,2,0,3,3,107,71,23,110,65,2,2,9,6,112,77,11,115,25,-3,-2,-4,1,194,73,24,197,66,-3,2,4,4
SUZLON,187,669,171,431,7,175,37,2,2,4,5,4,82,434,26,86,38,2,2,8,6,228,431,8,232,49,-2,2,-4,4,184,428,20,188,70,-3,3,2,0
SANOFI,188,668,162,78,14,160,29,2,2,2,5,-2,94,78,19,92,59,2,2,6,6,232,74,15,230,47,-3,2,-3,0,182,76,15,180,70,-2,3,2,3
HUDCO,189,667,258,458,11,259,62,2,2,3,6,1,110,453,26,111,65,2,2,9,6,100,464,-10,101,39,-3,0,-2,1,198,458,24,199,65,-2,2,5,5
GSFC,190,666,171,335,16,179,29,2,2,3,5,8,85,331,19,93,59,-3,2,3,5,236,333,16,244,47,-3,0,-4,3,166,333,15,174,67,-3,3,1,0
JUBLPHARMA,191,666,279,294,16,325,63,2,2,4,6,46,57,299,9,103,31,2,2,7,6,124,304,-12,170,47,-3,0,-2,1,160,297,19,206,49,-2,2,8,4
ASAHIINDIA,192,665,297,232,21,309,63,2,2,5,6,12,92,236,18,104,65,-3,2,6,4,80,248,-10,92,39,-3,0,-4,-2,184,235,8,196,69,2,2,6,5
KEC,193,656,285,267,19,301,63,2,2,3,6,16,105,264,21,121,66,2,2,8,6,32,280,-8,48,25,-3,-2,-4,0,218,263,23,234,69,2,2,8,5
CYIENT,194,653,258,272,13,267,63,2,2,3,3,9,98,267,24,107,59,1,2,7,5,116,276,4,125,33,-3,-2,-3,0,172,274,16,181,69,-3,2,2,0
BPCL,195,653,135,148,-6,137,47,-2,3,1,2,2,102,140,18,104,65,2,2,9,6,220,144,-3,222,49,2,2,1,4,194,140,21,196,65,1,2,4,4
FINCABLES,196,651,204,206,19,204,35,2,2,5,5,0,83,212,18,83,59,-3,2,3,4,240,205,-4,240,59,-2,0,4,3,124,212,12,124,44,-3,1,5,3
SCHNEIDER,197,651,261,99,21,343,59,1,2,-1,5,82,112,97,28,194,65,2,2,9,6,-20,113,-8,62,15,-3,-2,-6,-1,216,98,26,298,69,2,2,4,5
SAREGAMA,198,651,255,44,13,257,63,2,2,2,3,2,84,53,14,86,66,-3,2,1,4,168,52,14,170,39,-3,0,-4,-4,142,51,3,144,59,-2,2,4,5
TCS,199,645,144,468,-6,149,41,2,3,5,3,5,94,461,18,99,65,2,2,6,1,232,457,10,237,35,2,2,6,3,170,465,14,175,66,-3,2,2,4
RBLBANK,200,643,177,365,15,180,29,2,2,6,5,3,13,378,14,16,-15,2,2,5,5,276,358,16,279,55,-3,0,-2,3,174,364,14,177,68,-3,3,1,4
UNOMINDA,201,643,285,11,18,297,63,2,2,4,6,12,96,11,18,108,66,-3,2,8,5,60,23,-15,72,39,-3,0,-5,-1,190,12,15,202,70,-2,2,7,3
ADANIPOWER,202,642,252,195,16,336,61,2,2,-1,4,84,100,195,21,184,65,-2,2,8,6,12,209,-9,96,25,-3,-2,-5,-3,194,195,19,278,70,-3,2,4,5
PNBHOUSING,203,642,210,109,19,219,35,2,2,6,6,9,35,125,15,44,6,2,2,6,4,248,107,18,257,49,-3,0,-2,0,140,116,13,149,54,-3,1,2,3
BANKBARODA,204,639,210,465,3,214,63,2,2,-1,1,4,105,455,21,109,65,2,2,9,6,132,461,-7,136,41,-3,2,-4,4,188,460,18,192,65,2,2,3,4
"L&TFH",205,639,261,43,11,265,63,2,2,3,6,4,92,46,16,96,59,2,2,7,6,100,54,-10,104,41,-3,0,-4,1,182,43,18,186,69,-3,2,2,3
BAYERCROP,206,632,99,117,13,100,5,2,2,5,6,1,84,115,11,85,59,2,2,5,5,276,105,13,277,41,2,2,6,5,172,111,13,173,67,-3,3,1,5
SAFARI,207,629,174,366,15,178,29,2,2,5,5,4,91,364,23,95,60,-3,2,4,5,272,359,21,276,49,-3,2,-4,3,88,372,-10,92,54,-3,1,1,1
WELSPUNLIV,208,628,225,302,4,226,61,2,2,1,5,1,92,306,16,93,60,2,2,6,6,136,306,18,137,25,-3,-2,-5,1,174,306,14,175,69,-3,3,1,3
ADANIENT,209,626,180,466,-8,180,61,2,2,-1,4,0,90,464,16,90,66,-3,2,4,5,168,459,-4,168,49,-3,0,-4,4,188,462,16,188,65,2,2,6,3
IOC,210,624,219,463,5,219,63,2,2,-1,2,0,107,456,23,107,65,2,2,9,6,104,463,-5,104,41,-3,0,-4,-3,194,459,24,194,66,-3,2,4,4
SUPREMEIND,211,624,216,277,13,216,53,1,2,-1,4,0,90,276,20,90,59,1,2,2,6,152,275,-10,152,45,-2,3,5,-3,166,276,14,166,70,-3,2,-1,1
SJVN,212,621,240,426,6,249,62,2,2,3,5,9,110,422,26,119,65,2,2,9,6,80,434,7,89,25,-3,-2,-4,-3,182,427,19,191,65,-3,2,4,4
BIOCON,213,619,258,457,8,262,63,2,2,5,6,4,5,479,-6,9,-1,2,3,2,5,268,456,18,272,49,-3,0,-1,4,84,472,17,88,17,-2,2,4,4
TRITURBINE,214,617,255,452,18,332,59,2,2,0,4,77,97,452,18,174,65,-2,2,8,6,-20,468,-9,57,15,-2,-2,-5,-2,208,452,17,285,69,2,2,8,6
LAURUSLABS,215,616,279,105,17,291,63,2,2,4,5,12,69,118,8,81,52,-3,3,5,4,68,112,-13,80,39,-3,0,-4,-2,188,105,10,200,69,2,2,7,4
TANLA,216,610,129,22,17,138,9,2,2,7,6,9,78,16,13,87,60,-3,2,1,5,280,10,19,289,41,2,2,1,5,114,23,12,123,37,-2,1,5,4
LINDEINDIA,217,609,231,391,16,311,59,-3,2,0,3,80,102,387,24,182,65,-3,2,9,5,-12,403,-8,68,15,-3,-2,-3,-2,208,387,17,288,69,2,2,8,6
BANKINDIA,218,605,234,47,3,238,63,2,2,3,5,4,83,51,21,87,44,2,2,8,6,104,53,12,108,25,-3,-2,-4,-2,180,44,18,184,65,-2,2,3,4
INDUSINDBK,219,603,249,14,6,249,63,2,2,5,5,0,84,20,14,84,59,-3,2,7,5,136,22,-7,136,47,-3,0,-3,0,134,21,-5,134,70,-3,2,2,1
UCOBANK,220,601,219,276,4,220,61,2,2,-1,5,1,87,278,26,88,44,2,2,8,5,104,279,14,105,25,-3,-2,-5,-3,190,271,21,191,66,-2,2,3,5
BIRLACORPN,221,601,129,246,10,133,23,2,2,4,2,4,94,240,19,98,59,2,2,6,6,196,242,13,200,39,-2,2,-1,-2,178,243,18,182,65,-3,3,2,4
PPLPHARMA,222,600,285,39,19,293,63,2,2,3,6,8,-43,61,-13,-35,-37,-2,3,1,5,276,45,23,284,47,-3,0,-2,4,74,55,6,82,25,-3,2,6,1
CHAMBLFERT,223,598,270,237,15,273,63,2,2,3,5,3,85,248,10,88,65,-3,2,7,4,80,249,-12,83,39,-3,0,-5,1,160,245,9,163,69,-2,2,3,-1
SKFINDIA,224,598,120,247,16,130,9,2,2,8,3,10,76,249,16,86,60,-3,0,2,1,328,232,17,338,61,2,2,0,0,64,250,4,74,17,2,4,5,0
APARINDS,225,597,255,356,16,331,61,2,2,-1,5,76,102,353,24,178,59,2,2,9,6,-32,367,-11,44,15,-3,-2,-5,-2,196,353,20,272,70,-2,2,4,4
IEX,226,596,198,361,14,207,35,2,2,8,5,9,-35,380,4,-26,-41,-3,3,4,-2,372,355,21,381,63,2,2,1,4,52,376,5,61,15,-3,2,6,1
IOB,227,595,231,462,8,232,61,2,2,-1,5,1,89,465,26,90,45,2,2,8,6,76,466,16,77,15,-3,-2,-5,-2,198,457,24,199,65,-2,2,4,6
JSWSTEEL,228,593,240,107,9,252,63,2,2,3,1,12,91,107,18,103,66,-3,2,7,1,80,111,-7,92,39,-3,-2,-5,-2,170,108,7,182,69,-2,2,6,3
PIDILITIND,229,592,234,296,16,309,59,-3,2,-1,5,75,93,293,16,168,65,-2,2,8,4,-16,308,-4,59,15,-3,-2,-6,-4,206,292,19,281,69,2,2,8,3
SUMICHEM,230,592,150,210,19,164,15,2,2,8,4,14,34,219,-7,48,44,-3,1,1,-2,372,196,24,386,63,-3,2,2,5,22,218,5,36,-1,2,3,5,-3
KOTAKBANK,231,591,174,244,10,185,35,2,2,6,3,11,56,251,6,67,50,-3,1,1,1,328,231,16,339,61,2,2,0,1,22,251,-7,33,11,2,3,5,-3
ITC,232,590,120,54,15,120,15,2,2,5,1,0,86,52,23,86,60,-3,2,1,3,300,42,16,300,61,-3,2,-1,0,84,54,10,84,29,-2,4,0,1
"J&KBANK",233,589,195,363,-7,199,63,2,2,2,3,4,102,359,24,106,59,2,2,9,6,112,365,-4,116,41,-3,0,-4,-2,176,363,18,180,66,-3,2,3,2
RVNL,234,587,186,404,-7,184,61,1,2,1,4,-2,97,405,26,95,58,2,2,4,5,120,402,-5,118,31,-3,4,2,1,186,402,21,184,66,-3,2,3,4
IGL,235,586,279,358,16,298,63,2,2,4,6,19,82,361,3,101,66,2,2,6,3,116,364,-10,135,47,-3,0,-2,-3,90,371,6,109,25,2,2,6,4
PIIND,236,585,234,461,14,240,59,-3,2,0,6,6,91,462,16,97,66,-3,2,7,3,60,467,13,66,15,-3,-2,-5,-3,194,456,12,200,69,2,2,7,5
IDBI,237,581,243,331,10,244,61,2,2,2,4,1,83,338,21,84,45,2,2,8,5,72,337,-12,73,39,-3,0,-3,-3,182,330,18,183,65,-2,2,3,5
NCC,238,579,252,142,13,253,62,2,2,0,5,1,104,139,21,105,65,2,2,9,5,28,149,-8,29,25,-3,-2,-3,-2,194,141,18,195,66,2,2,4,5
ENGINERSIN,239,570,264,328,15,265,61,2,2,2,6,1,101,326,19,102,64,2,2,8,6,16,339,-8,17,25,-3,-2,-5,-3,188,328,19,189,70,-3,2,2,4
CRAFTSMAN,240,568,135,80,16,144,15,2,2,5,5,9,76,82,16,85,57,-3,2,1,3,296,71,9,305,61,2,2,2,-2,52,88,-11,61,39,-3,1,0,0
CREDITACC,241,564,141,53,15,146,19,2,2,4,5,5,84,48,16,89,59,2,2,1,4,288,43,17,293,43,2,2,5,3,46,58,-10,51,36,-3,1,-1,0
NYKAA,242,561,294,37,17,312,63,2,2,8,6,18,-67,62,-15,-49,-55,-2,3,1,1,304,40,16,322,59,-3,2,1,1,12,59,9,30,-13,-2,2,7,3
ACE,243,560,213,38,13,298,55,-3,2,-1,5,85,112,35,28,197,65,2,2,9,6,-56,55,-15,29,9,-3,1,-3,-3,206,36,24,291,65,2,2,4,6
SHRIRAMFIN,244,556,258,397,16,259,61,2,2,-1,6,1,101,401,19,102,64,2,2,9,5,-4,405,-15,-3,25,-3,-2,-6,0,200,394,21,201,69,-2,2,4,6
INDIANB,245,553,240,460,8,240,61,2,2,2,5,0,107,457,24,107,65,2,2,9,5,28,469,-8,28,25,-3,-2,-5,0,178,464,18,178,65,-3,2,3,4
BHARATFORG,246,552,135,369,3,139,29,2,2,4,5,4,85,365,16,89,60,-3,2,7,3,152,363,7,156,29,2,2,-2,0,176,361,16,180,68,-3,3,1,3
HINDPETRO,247,552,135,309,4,137,33,2,3,2,1,2,101,300,19,103,65,2,2,8,5,136,305,15,138,9,2,2,2,4,178,305,20,180,64,-3,2,3,3
MARUTI,248,549,237,68,20,309,56,-2,2,-2,5,72,98,69,17,170,65,2,2,8,4,-56,79,-14,16,15,-3,-2,-5,-5,198,68,19,270,65,2,2,7,4
IRFC,249,547,189,428,-6,186,61,2,2,2,2,-3,103,427,28,100,58,2,2,8,5,72,436,16,69,15,-3,-2,-5,-3,186,429,21,183,65,-3,2,4,4
GRASIM,250,547,174,203,-4,249,55,2,2,-1,4,75,98,196,19,173,66,-3,2,8,6,32,207,-7,107,29,-3,-2,-6,-3,168,196,16,243,65,-3,2,3,1
FINPIPE,251,546,267,485,18,277,61,2,2,0,6,10,101,485,19,111,65,2,2,8,5,-28,490,-12,-18,15,-3,-2,-5,0,196,486,15,206,69,2,2,6,4
SHYAMMETL,252,545,132,150,4,125,29,2,2,2,5,-7,94,150,19,87,59,2,2,7,5,160,146,15,153,27,-3,0,-3,4,166,149,13,159,63,-3,3,2,5
GNFC,253,541,207,464,18,216,35,2,2,6,6,9,69,469,6,78,60,-3,2,2,2,120,462,-10,129,49,-3,0,-4,-2,136,468,12,145,53,-3,0,6,0
RELIANCE,254,535,198,304,10,198,57,-2,2,-1,0,0,97,304,16,97,65,2,2,8,4,48,309,-6,48,29,-3,0,-5,-3,192,302,19,192,65,2,2,3,5
KPRMILL,255,535,240,204,16,246,61,-3,2,2,2,6,87,207,20,93,59,-3,2,4,5,12,210,-12,18,9,2,3,0,1,190,203,18,196,70,-3,2,5,3
DCMSHRIRAM,256,532,105,433,13,112,9,2,2,5,4,7,80,433,16,87,59,-3,2,1,5,236,430,20,243,35,-3,2,-1,6,104,438,13,111,37,-3,1,4,0
MANKIND,257,529,243,396,11,261,61,2,2,-1,6,18,88,397,20,106,65,-2,2,1,2,0,404,-12,18,25,-3,-2,-5,-3,180,396,14,198,59,2,2,8,5
RCF,258,528,168,21,14,172,29,2,2,3,6,4,84,13,18,88,59,-3,2,2,6,156,21,16,160,27,-3,0,-4,3,116,24,-10,120,68,-3,1,1,1
UJJIVANSFB,259,525,177,179,18,178,29,2,2,3,5,1,73,188,18,74,39,2,2,6,6,132,181,-10,133,47,-3,3,-3,-1,142,184,15,143,54,-3,1,1,3
BIKAJI,260,522,174,146,18,175,29,2,2,3,4,1,87,149,13,88,65,-2,2,3,6,112,147,-13,113,41,-3,2,-4,5,148,150,13,149,58,-3,3,3,0
MAHABANK,261,521,246,359,13,247,62,2,2,-1,4,1,86,366,23,87,45,2,2,9,5,-4,369,-6,-3,15,-3,-2,-5,0,192,358,21,193,66,-2,2,4,5
LATENTVIEW,262,517,279,326,16,288,63,2,2,4,6,9,7,349,11,16,-14,-2,2,5,5,60,338,-12,69,39,-3,-2,-5,-2,162,334,19,171,49,-2,2,7,6
ADANIPORTS,263,513,195,72,9,267,57,1,2,-2,-2,72,106,67,21,178,66,2,2,9,6,-56,78,-10,16,9,-3,-2,-6,-2,196,69,21,268,65,2,2,4,4
OIL,264,512,222,205,16,219,56,-2,2,-2,4,-3,109,202,26,106,64,2,2,9,6,-20,212,-7,-23,15,-3,-2,-5,-3,204,201,24,201,65,2,2,4,5
APLLTD,265,503,174,492,10,171,43,2,2,-4,5,-3,98,491,15,95,65,2,2,8,6,48,489,-7,45,21,-2,1,-1,0,186,490,21,183,65,-2,2,1,6
OBEROIRLTY,266,503,234,49,13,237,59,1,2,-1,4,3,102,40,21,105,65,1,2,8,5,-24,57,-9,-21,15,-3,-2,-4,-3,188,42,18,191,69,-2,2,3,4
ADANIGREEN,267,502,183,19,4,180,57,-3,2,-2,3,-3,90,15,15,87,65,-3,2,6,5,48,24,9,45,15,-3,-2,-3,-4,184,16,18,181,65,-3,2,4,6
GMRINFRA,268,496,204,241,-3,205,61,2,2,1,5,1,101,237,24,102,59,2,2,8,6,8,250,-10,9,25,-3,-2,-5,-3,182,241,20,183,66,-3,2,3,3
SPARC,269,494,228,274,12,240,57,2,2,-1,4,12,100,266,17,112,65,2,2,8,6,-44,282,-20,-32,15,-3,1,-5,1,198,266,19,210,69,2,2,3,4
SUNTV,270,494,126,149,10,132,19,2,2,4,5,6,84,147,13,90,59,1,2,3,6,228,142,16,234,35,1,2,-2,5,50,155,-13,56,44,-3,1,-1,-3
SBILIFE,271,492,186,364,6,184,61,-3,2,-1,-3,-2,84,368,14,82,59,-3,2,7,5,60,366,-5,58,29,-3,0,-3,-3,164,366,14,162,66,-3,2,0,3
GODFRYPHLP,272,491,168,143,13,240,50,-3,0,-4,0,72,109,131,26,181,65,2,2,9,5,-52,150,12,20,-19,-3,1,-5,1,194,133,24,266,65,2,2,1,3
CARBORUNIV,273,488,240,488,16,247,55,2,2,0,5,7,89,490,16,96,66,-3,2,4,4,-44,492,-10,-37,9,-3,-2,-6,1,196,487,15,203,69,2,2,6,4
WHIRLPOOL,274,487,222,333,21,240,35,2,2,8,6,18,-23,351,-8,-5,-13,-2,1,1,-2,312,328,16,330,61,-3,2,1,1,-42,350,18,-24,-46,2,3,6,-4
AAVAS,275,486,207,177,19,222,35,2,2,6,5,15,0,190,-6,15,0,-3,4,2,3,316,172,24,331,55,-3,0,-1,4,-52,190,10,-37,-44,2,3,6,-3
AIAENG,276,485,231,275,13,228,57,2,2,-2,5,-3,99,271,24,96,59,2,2,7,5,-28,281,-12,-31,15,-3,-2,-4,-1,186,272,21,183,70,-2,2,2,0
CHOLAFIN,277,481,243,459,16,249,53,2,2,2,6,6,86,463,21,92,59,-3,2,4,3,12,470,-10,18,25,-3,-2,-4,-3,134,469,12,140,54,-2,3,4,-4
NATCOPHARM,278,481,189,145,13,187,49,-3,0,-1,5,-2,92,148,17,90,59,2,2,7,5,16,151,16,14,-13,-2,4,3,-4,186,146,16,184,65,2,2,3,5
LICI,279,475,240,332,13,241,61,2,2,1,1,1,62,344,14,63,36,-2,2,6,6,-12,343,-8,-11,15,-3,1,-4,-4,184,329,21,185,65,-3,2,3,4
NH,280,474,195,208,8,186,57,2,2,-2,-2,-9,100,208,24,91,59,2,2,7,6,0,211,-3,-9,15,-3,-2,-5,-2,188,208,20,179,69,-3,2,2,4
MINDACORP,281,467,222,490,13,219,57,2,2,-2,2,-3,102,488,24,99,59,2,2,9,6,-24,491,-7,-27,15,-3,-2,-4,-5,170,493,16,167,65,-3,2,0,5
AXISBANK,282,455,117,248,4,120,29,2,2,2,0,3,81,250,14,84,59,-3,2,6,3,92,247,14,95,19,-3,0,-4,-3,162,244,11,165,68,-3,3,1,1
TEJASNET,283,452,129,310,16,135,15,2,2,3,5,6,83,309,18,89,59,-3,2,2,5,124,307,-12,130,47,-3,0,-2,1,110,313,11,116,37,-2,4,5,0
IRCON,284,451,171,467,-7,168,57,2,2,-2,5,-3,103,460,26,100,59,2,2,9,5,-4,472,-3,-7,15,-3,-2,-6,-2,184,463,20,181,66,-3,2,3,4
AMBER,285,450,180,429,-5,182,55,2,2,1,5,2,92,431,19,94,59,2,2,6,4,4,437,-3,6,15,-3,1,-5,-4,172,431,15,174,69,-3,2,2,1
TIMKEN,286,434,33,215,13,45,-15,2,2,5,4,12,69,213,18,81,52,-3,0,-1,3,340,198,10,352,61,2,2,6,4,-20,221,-10,-8,-7,-2,4,2,3
CANFINHOME,287,433,240,360,16,241,57,2,2,-2,5,1,82,367,17,83,59,-3,2,6,1,-40,370,-15,-39,15,-3,-2,-4,-1,150,369,6,151,68,-2,2,1,0
APOLLOTYRE,288,431,-12,252,-13,-9,-3,2,3,4,3,3,92,245,21,95,59,1,2,4,5,196,243,16,199,19,2,2,6,4,152,248,16,155,59,-3,0,1,3
JKCEMENT,289,430,198,207,-5,199,61,2,2,1,5,1,99,205,18,100,66,1,2,7,5,-48,213,-13,-47,15,-3,-2,-4,-5,180,207,19,181,65,-3,2,3,4
SUNDRMFAST,290,430,42,24,14,54,-15,2,2,6,5,12,72,19,18,84,54,-3,0,0,3,304,9,21,316,55,-3,2,0,1,0,27,-13,12,13,-2,1,3,-2
SOLARINDS,291,424,192,106,16,260,55,-3,0,-2,-2,68,110,99,26,178,65,2,2,9,6,-140,115,-10,-72,-11,-3,-2,-6,-3,194,100,24,262,66,-3,2,4,4
AUROPHARMA,292,422,210,402,13,204,55,2,2,-2,0,-6,94,406,19,88,59,2,2,7,5,-52,406,-14,-58,15,-3,-2,-7,-2,176,404,18,170,69,-3,2,2,0
JWL,293,417,213,76,7,207,57,2,2,-2,5,-6,94,81,24,88,59,1,2,4,4,-64,81,-12,-70,9,-3,-2,-6,-2,180,77,16,174,70,-3,2,2,3
CHEMPLASTS,294,417,198,18,13,207,35,2,2,8,6,9,-28,29,3,-19,-44,2,3,4,4,188,18,-12,197,59,-2,2,0,0,50,25,6,59,9,-2,3,6,3
KFINTECH,295,415,198,77,10,200,51,2,2,-4,5,2,91,77,19,93,65,-2,2,4,3,-20,80,-7,-18,15,-3,-2,-5,-3,144,80,18,146,53,-3,2,0,2
GMMPFAUDLR,296,409,66,407,21,80,-15,2,2,7,5,14,33,413,14,47,24,-3,-2,-1,1,352,390,21,366,61,2,2,1,1,-56,414,-13,-42,-15,-2,4,3,-5
ELECON,297,409,198,305,7,195,49,2,2,1,5,-3,90,311,24,87,59,-3,2,4,4,-52,311,-14,-55,15,-3,-2,-4,-5,176,307,14,173,69,-3,3,1,4
HAVELLS,298,409,207,110,13,204,55,-3,0,-1,5,-3,91,114,15,88,65,-3,2,7,5,-80,117,-10,-83,-1,-3,1,-4,-3,194,106,18,191,65,2,2,5,5
ASTRAZEN,299,408,54,281,11,53,-3,2,3,2,3,-1,91,277,21,90,59,2,2,1,6,108,278,20,107,7,-3,0,-2,5,156,277,15,155,61,-3,3,1,1
BOSCHLTD,300,407,177,487,14,250,50,-3,0,-2,0,73,105,483,21,178,65,2,2,9,6,-156,495,-13,-83,-19,-3,4,-4,-4,208,483,24,281,65,2,2,6,5
AUBANK,301,403,63,471,18,73,-15,2,2,8,6,10,50,474,9,60,45,-3,0,1,-2,324,453,17,334,61,-2,2,3,0,-44,478,-13,-34,-14,-2,4,3,0
LT,302,401,177,209,13,177,49,-3,2,-2,0,0,104,203,26,104,59,2,2,9,6,-64,214,-9,-64,9,-3,-2,-6,-5,184,206,20,184,69,-3,2,3,1
SIGNATURE,303,399,135,338,-10,132,50,2,2,-3,4,-3,89,336,22,86,64,-2,2,1,2,8,340,-13,5,29,-3,-2,-4,-5,170,335,24,167,55,-2,2,2,4
BALAMINES,304,396,39,217,13,43,-15,2,2,5,6,4,39,220,4,43,32,-3,4,-1,3,300,202,9,304,59,2,2,0,3,14,220,3,18,-1,-3,1,4,3
POWERGRID,305,396,165,147,10,162,41,2,2,-4,4,-3,106,143,21,103,66,2,2,9,6,-52,152,-13,-55,15,-3,-2,-5,-5,180,148,20,177,65,-3,2,2,4
LALPATHLAB,306,388,54,55,16,64,-15,2,2,7,6,10,18,58,-6,28,26,-3,3,-3,1,304,41,17,314,43,2,2,8,4,2,60,-12,12,9,-3,1,3,3
ICICIGI,307,381,117,339,-5,114,49,-3,2,-4,0,-3,97,330,15,94,65,2,2,8,5,-28,344,-10,-31,15,-3,-2,-5,-2,198,326,23,195,65,2,2,2,5
PRESTIGE,308,372,156,368,9,153,41,2,2,-2,0,-3,101,362,24,98,59,2,2,9,5,-56,373,-11,-59,9,-3,-2,-6,-1,174,365,18,171,70,-3,2,0,0
COLPAL,309,372,126,242,-4,201,47,-3,0,-1,3,75,101,229,23,176,59,2,2,9,6,-116,251,-11,-41,-19,2,3,-1,-3,186,230,23,261,65,-3,2,2,4
JSL,310,371,102,20,-9,173,50,-3,0,-2,-2,71,110,6,26,181,65,2,2,9,6,-84,25,-15,-13,9,-3,-2,-5,-5,172,8,16,243,66,-3,2,2,3
NAVINFLUOR,311,370,51,313,14,66,-15,2,2,8,6,15,10,318,-13,25,31,-3,1,-4,-2,392,291,17,407,63,2,2,8,6,-98,319,-15,-83,-39,2,4,2,-3
CROMPTON,312,367,123,311,16,133,9,2,2,8,4,10,-8,319,-8,2,-4,-3,4,2,1,316,299,17,326,43,2,2,9,6,-74,318,3,-64,-45,-2,1,5,1
POLYMED,313,360,144,181,-6,143,51,2,2,-1,0,-1,91,179,19,90,59,-2,2,7,6,-36,182,-9,-37,9,-2,-2,-3,-2,162,179,16,161,63,-3,2,0,3
APLAPOLLO,314,359,150,336,-3,151,55,-3,2,-1,0,1,86,335,21,87,59,-3,2,3,4,0,341,-3,1,15,-3,-2,-4,-3,122,343,4,123,55,-3,3,4,-2
AMBUJACEM,315,356,144,245,-3,138,49,-3,2,-2,5,-6,102,243,19,96,65,2,2,8,6,-72,252,-16,-78,15,-3,-2,-7,-5,188,242,18,182,65,2,2,2,5
ONGC,316,341,105,371,-6,102,41,2,2,-4,0,-3,105,360,21,102,65,2,2,9,6,-56,372,-11,-59,9,-3,-2,-4,-3,190,359,24,187,65,-3,2,2,5
BALKRISIND,317,337,36,345,13,42,-9,2,2,3,1,6,77,339,14,83,59,-3,2,1,4,132,335,-5,138,47,-3,0,-4,-2,86,345,8,92,33,-2,4,0,0
FINEORG,318,334,36,154,16,40,-15,2,2,5,2,4,60,156,13,64,52,-3,-2,-3,3,264,139,20,268,49,-3,2,-4,2,-30,157,3,-26,-15,-2,1,2,-4
ABFRL,319,328,141,337,19,142,15,2,2,3,6,1,60,345,4,61,49,-3,4,2,4,76,336,-10,77,39,-3,0,-5,-2,50,346,11,51,9,-2,0,4,3
SBFC,320,322,75,434,5,85,9,2,2,6,1,10,-41,447,-10,-31,-29,-2,1,0,-1,308,424,17,318,43,2,2,7,6,-30,442,10,-20,-35,2,1,5,2
FIVESTAR,321,318,210,491,14,208,53,2,2,2,-3,-2,88,494,18,86,65,-2,2,4,1,-48,494,-15,-50,9,-3,1,-3,-1,70,496,-8,68,43,-2,3,1,-2
OFSS,322,308,93,307,-10,161,48,-3,0,-2,-2,68,105,292,21,173,65,2,2,9,6,-164,312,-14,-96,-19,-3,1,-1,-5,206,293,26,274,65,2,2,2,6
RHIM,323,308,54,278,16,68,-15,2,2,7,6,14,36,283,-10,50,46,-3,0,-1,4,272,269,16,286,41,-2,2,8,3,-68,284,-13,-54,-18,-3,1,2,-3
DEEPAKFERT,324,304,51,342,14,60,-9,2,2,3,5,9,44,346,13,53,38,-3,-2,-3,1,204,334,8,213,47,-3,0,-4,3,-4,348,6,5,-15,-2,4,2,3
ROUTE,325,300,108,341,-10,103,49,2,2,-2,-5,-5,79,340,11,74,59,-3,2,6,4,-48,345,-16,-53,1,-2,1,3,1,166,337,16,161,69,-3,2,1,-2
PRINCEPIPE,326,298,48,374,18,57,-15,2,2,4,5,9,61,375,14,70,46,-3,0,-1,5,224,360,16,233,47,-3,0,-2,-2,-44,381,-8,-35,-15,-3,1,3,0
MRPL,327,298,141,308,4,138,50,-3,0,-4,0,-3,110,298,26,107,65,2,2,9,6,-144,314,-13,-147,-11,-3,-2,-5,-2,194,303,24,191,65,-2,2,2,6
CGPOWER,328,293,165,367,14,169,47,-3,0,-4,1,4,92,363,24,96,60,-3,2,4,5,-144,375,-10,-140,-19,2,1,-7,-3,176,362,16,180,65,2,2,0,3
ZYDUSLIFE,329,287,96,493,-10,164,48,-3,0,-4,1,68,105,484,23,173,64,2,2,9,5,-184,497,-11,-116,-19,-3,-2,-6,-5,202,484,24,270,65,2,2,3,5
ISEC,330,286,-3,441,4,-6,-11,2,4,2,-2,-3,88,435,16,85,59,2,2,4,5,72,435,13,69,-9,2,2,6,4,132,436,21,129,51,-3,0,-1,-2
RENUKA,331,282,0,250,13,1,-25,2,2,4,4,1,63,252,18,64,46,-3,0,-1,3,244,241,19,245,39,-3,2,-1,5,-26,252,5,-25,-19,-3,1,2,1
JKPAPER,332,281,-30,472,16,-29,-39,2,2,5,4,1,70,471,16,71,54,-3,0,-1,4,212,458,20,213,35,-3,2,-1,0,28,476,8,29,9,-3,1,-1,0
AETHER,333,275,39,344,15,43,-15,2,2,5,4,4,28,348,14,32,19,-2,-2,-1,0,280,330,24,284,41,-3,2,2,4,-76,351,-7,-72,-39,2,4,2,0
DEVYANI,334,273,33,495,11,45,-15,2,2,6,5,12,24,499,-8,36,38,-3,0,-1,-2,248,485,18,260,37,2,2,-1,4,-44,498,-12,-32,-14,-2,4,2,0
PFC,335,273,117,151,-3,121,37,2,2,0,1,4,102,137,26,106,59,2,2,8,5,-124,153,-9,-120,-9,-3,-2,-5,-3,174,147,23,178,64,-3,2,0,1
KNRCON,336,269,3,497,6,4,-15,2,2,2,4,1,71,496,11,72,57,-3,0,1,5,128,488,13,129,27,-3,0,-2,-3,66,497,-7,67,39,-3,1,-1,4
MARICO,337,266,21,437,10,22,-15,2,2,4,4,1,38,442,-4,39,46,-3,0,-1,0,244,429,16,245,41,-3,2,0,5,-38,443,3,-37,-19,-3,1,2,-3
CHENNPETRO,338,265,117,116,-3,111,41,1,0,-4,4,-6,104,110,26,98,59,2,2,9,6,-128,121,-8,-134,-11,-3,-2,-6,-2,178,113,20,172,63,-3,2,2,5
GRINDWELL,339,263,-3,282,8,1,-25,2,2,6,6,4,70,280,16,74,54,-3,0,-1,4,192,273,-4,196,41,-3,2,7,5,0,281,-6,4,9,-3,1,-1,0
SBICARD,340,250,45,343,18,56,-15,2,2,6,2,11,-20,352,-7,-9,-7,-3,1,-1,-3,324,327,24,335,55,-3,0,1,4,-110,352,-11,-99,-53,2,4,3,0
LXCHEM,341,249,51,280,16,57,-15,2,2,6,6,6,16,285,10,22,7,-3,-2,1,3,304,265,19,310,43,2,2,6,4,-128,286,-8,-122,-59,-3,1,2,3
SWANENERGY,342,248,126,115,-3,125,43,2,2,-4,2,-1,103,108,21,102,65,2,2,7,6,-92,118,-9,-93,-9,-3,-2,-4,4,112,120,-12,111,63,-3,2,1,5
TATACOMM,343,248,105,81,-5,112,41,-3,0,-2,4,7,96,74,21,103,60,2,2,7,4,-140,84,-16,-133,-11,-3,1,-1,-5,180,74,16,187,65,2,2,0,5
PRSMJOHNSN,344,243,180,180,16,175,41,1,0,-4,6,-5,94,180,18,89,59,2,2,7,6,-204,187,-15,-209,-25,-3,1,-8,-1,178,177,18,173,67,-3,2,0,5
UNIONBANK,345,238,147,432,11,141,41,-3,0,-4,4,-6,87,436,24,81,44,2,2,9,6,-168,441,-10,-174,-19,-3,-2,-5,-3,178,432,20,172,64,-2,2,1,4
TRIDENT,346,233,78,212,10,76,9,2,2,2,1,-2,79,214,13,77,60,-3,2,2,5,-68,215,13,-70,-19,-3,-2,-4,-2,146,210,13,144,55,-3,3,1,4
PVRINOX,347,215,42,213,13,51,-15,2,2,7,5,9,-6,223,-4,3,7,-3,-2,-4,0,288,203,16,297,41,2,2,7,4,-118,223,-15,-109,-43,-3,4,2,-4
HAPPSTMNDS,348,209,-3,440,13,1,-25,2,2,4,3,4,10,443,-7,14,24,-3,-2,-3,1,280,426,21,284,41,-3,2,6,3,-82,445,4,-78,-43,-3,1,2,-2
STLTECH,349,208,51,183,17,57,-15,2,2,5,6,6,-25,191,-9,-19,-15,-3,1,-2,3,264,175,19,270,49,-3,0,-2,3,-88,191,3,-82,-53,-2,1,3,4
OLECTRA,350,208,159,79,10,153,43,2,0,-4,2,-6,95,79,23,89,59,-3,2,8,6,-220,88,-8,-226,-35,-3,-2,-5,-2,180,78,21,174,64,-3,2,1,5
ALKYLAMINE,351,201,54,25,18,52,-15,2,2,5,6,-2,5,28,-10,3,20,-3,-2,-4,4,204,17,16,202,35,-3,2,-2,3,-60,29,5,-62,-39,-2,1,2,3
UPL,352,189,45,153,15,59,-15,2,2,7,4,14,-28,159,-12,-14,-6,-3,1,-4,-4,296,137,14,310,59,-2,2,1,0,-138,159,-15,-124,-59,2,4,2,-3
HDFCBANK,353,187,111,469,16,123,9,2,2,4,4,12,62,470,11,74,54,-3,1,1,-2,-16,471,-15,-4,25,-3,-2,-5,-4,18,475,8,30,-9,2,3,4,1
JSWINFRA,354,169,87,23,-7,84,39,-3,0,-4,4,-3,83,21,18,80,65,-2,2,1,-1,-140,27,-8,-143,-19,-3,4,-6,-3,142,20,13,139,53,-2,2,1,4
TRIVENI,355,167,87,406,3,88,17,2,2,2,3,1,83,408,18,84,59,-3,2,2,5,-72,407,-10,-71,-5,-3,0,-3,3,68,412,4,69,29,-3,1,-1,4
HBLPOWER,356,166,63,182,-10,60,27,2,2,-4,4,-3,100,177,26,97,59,2,2,5,6,-144,185,-12,-147,-9,-3,-2,-5,-5,150,182,16,147,59,-3,0,0,3
ERIS,357,162,-12,376,3,-12,-15,2,4,2,0,0,78,372,14,78,57,1,2,0,4,20,368,3,20,-9,2,2,4,3,76,374,13,76,30,-3,-2,-3,3
PAGEIND,358,161,15,27,10,21,-15,2,2,2,4,6,32,26,10,38,30,-3,1,-3,-3,160,20,15,166,29,-3,0,-4,3,-52,28,-10,-46,-15,-2,1,2,-2
JMFINANCIL,359,158,-87,190,-13,-86,-28,2,3,2,5,1,74,187,14,75,53,2,2,-1,4,156,178,19,157,17,-3,2,0,4,14,189,-13,15,24,-3,1,-2,0
MAHSEAMLES,360,144,-9,185,4,-5,-15,2,3,0,3,4,97,174,24,101,59,2,2,4,6,-112,183,7,-108,-29,-3,-2,-5,4,164,178,20,168,62,-3,3,0,0
TORNTPHARM,361,139,51,435,-6,51,25,-2,-2,-3,5,0,98,428,21,98,60,2,2,9,4,-188,442,-5,-188,-43,2,1,-3,1,178,430,20,178,63,-3,2,2,5
CRISIL,362,134,90,312,16,84,25,-3,-2,-3,-3,-6,104,303,21,98,66,2,2,7,6,-240,317,-7,-246,-43,2,-2,-6,-4,186,304,20,180,63,2,2,1,5
NESTLEIND,363,113,27,347,-3,30,15,-3,1,-1,0,3,87,333,18,90,59,2,2,1,5,-144,346,7,-141,-49,2,2,2,0,140,340,14,143,60,-3,2,-1,-2
PERSISTENT,364,109,9,249,-15,3,13,2,4,-2,1,-6,94,247,24,88,59,-3,2,7,5,-144,254,-9,-150,-31,2,2,2,-2,156,249,21,150,59,-3,0,0,1
RAILTEL,365,107,33,496,-7,34,13,1,3,-4,5,1,99,487,23,100,59,2,2,7,6,-200,499,-7,-199,-29,-3,-2,-6,-3,174,492,20,175,64,-3,2,0,4
AJANTPHARM,366,102,108,470,11,102,29,-3,0,-5,4,-6,94,466,18,88,59,2,2,7,6,-248,477,-13,-254,-43,1,1,-6,-2,154,467,18,148,59,-3,2,0,1
TMB,367,101,30,120,11,27,-11,2,2,1,5,-3,74,121,13,71,59,-2,2,-1,3,-16,114,-8,-19,15,-3,-2,-4,-2,16,124,-6,13,13,-3,4,2,-2
ATUL,368,93,-36,284,16,-27,-39,2,2,6,1,9,-12,287,-10,-3,9,-3,-2,-4,-2,292,267,16,301,43,2,2,4,6,-160,287,-13,-151,-63,-3,1,1,-3
ECLERX,369,91,30,346,4,31,-1,2,2,-1,4,1,88,334,18,89,59,-3,2,7,5,-188,347,-5,-187,-29,-3,-2,-4,-4,160,338,16,161,61,-3,3,-1,4
ADANIENSOL,370,88,105,340,8,109,17,2,2,2,4,4,11,350,-8,15,18,-3,4,0,0,-12,342,-6,-8,9,-2,1,-5,0,-20,349,15,-16,-30,-2,2,4,1
EMAMILTD,371,87,-6,439,10,1,-25,2,2,4,5,7,44,441,11,51,39,-3,0,-3,0,140,433,-5,147,41,-3,2,2,-2,-98,446,-10,-91,-35,-3,1,-1,-1
RATNAMANI,372,86,90,82,4,91,17,2,2,1,4,1,79,84,23,80,57,-3,2,0,0,-180,86,-12,-179,-19,-3,-2,-4,-5,96,86,17,97,34,-3,1,-1,0
MHRIL,373,83,69,152,-9,66,33,2,0,-4,1,-3,89,154,21,86,59,-3,2,4,6,-208,156,-7,-211,-35,-3,1,-5,-3,136,152,11,133,54,-3,3,-1,4
PCBL,374,81,27,184,-6,18,5,2,2,0,6,-9,97,182,21,88,59,2,2,7,6,-196,186,-8,-205,-29,-3,-2,-5,-2,162,181,13,153,64,-3,3,-1,5
TVSSCS,375,79,18,57,16,19,-25,2,2,6,5,1,-50,63,16,-49,-59,-2,-2,-2,-1,256,46,15,257,41,-3,2,5,4,-146,63,-10,-145,-63,-2,1,1,0
HAPPYFORGE,376,78,-6,83,-3,1,-15,2,2,6,6,7,-79,96,-13,-72,-59,-2,-2,-2,-1,308,70,16,315,43,2,2,8,6,-152,96,-13,-145,-63,-2,1,0,1
INDIACEM,377,76,-3,315,13,1,-25,2,2,2,5,4,69,314,14,73,53,-3,2,-1,4,-8,310,13,-4,-5,-3,0,-4,-3,14,315,-6,18,15,-3,1,-1,1
TITAGARH,378,73,48,216,4,45,5,2,2,1,2,-3,88,210,24,85,57,-3,2,2,6,-228,217,-12,-231,-29,-3,-2,-6,-5,168,209,18,165,62,-3,3,1,3
SUNPHARMA,379,71,69,279,-9,59,39,-3,0,-4,0,-10,104,274,23,94,65,2,2,7,5,-284,287,-14,-294,-43,-3,-2,-6,-3,192,273,23,182,63,2,2,1,5
YESBANK,380,69,126,494,4,127,37,2,2,-4,1,1,-12,500,13,-11,-39,2,2,5,5,-116,496,-8,-115,-9,-3,-2,-5,-2,70,495,20,71,15,-3,0,-1,4
SUNTECK,381,68,117,370,11,112,17,2,2,2,5,-5,78,373,11,73,60,-3,2,4,4,-216,376,-15,-221,-29,-3,-2,-4,-1,94,373,4,89,43,-3,1,1,1
VBL,382,67,75,409,-6,69,39,-3,0,-5,0,-6,104,403,26,98,59,2,2,9,6,-288,411,-13,-294,-43,-3,-2,-6,-5,182,403,24,176,64,-3,2,1,3
BLS,383,65,-57,187,-11,-61,-15,2,3,-1,3,-4,90,183,24,86,59,-3,2,4,4,-112,184,10,-116,-29,-3,1,-5,-2,148,183,15,144,60,-3,0,-1,3
ULTRACEMCO,384,62,78,373,4,66,25,2,0,-5,0,-12,90,371,17,78,60,1,2,5,5,-244,380,-9,-256,-35,-3,-2,-7,-5,150,370,18,138,60,-3,0,-1,1
VARROC,385,61,78,408,-3,75,25,2,2,-4,4,-3,20,414,19,17,-14,2,2,6,5,-184,408,-16,-187,-15,-3,-2,-7,-3,150,406,14,147,61,-3,3,-1,1
HDFCAMC,386,54,27,121,-8,22,25,-3,-2,-3,0,-5,96,113,19,91,59,2,2,8,6,-244,124,-9,-249,-43,-2,-2,-6,1,180,109,23,175,63,-3,2,1,4
GODREJCP,387,49,42,436,6,39,15,-2,1,-4,-2,-3,96,432,16,93,65,2,2,7,4,-240,444,-5,-243,-43,-3,-2,-4,-3,154,434,16,151,59,-3,2,0,3
CHOLAHLDNG,388,47,63,118,-3,59,31,-3,0,-2,-2,-4,86,117,19,82,59,2,2,1,3,-248,125,-13,-252,-35,-3,1,-7,-5,150,117,14,146,60,-3,2,-1,3
APTUS,389,43,21,122,8,19,-9,2,3,0,3,-2,2,127,10,0,-19,2,2,4,3,-80,116,4,-82,-27,-2,3,-4,6,102,122,14,100,36,-3,3,1,0
EASEMYTRIP,390,33,-75,91,-9,-84,-15,2,3,-4,-2,-9,91,83,21,82,66,-3,2,2,3,-96,82,14,-105,-29,-3,1,-4,-3,122,84,13,113,43,2,0,-1,4
ANGELONE,391,20,54,214,14,51,-1,2,2,0,1,-3,89,209,24,86,59,-3,2,1,6,-204,216,-9,-207,-35,-3,4,-5,-3,84,215,-11,81,56,-3,3,-1,-2
GESHIP,392,19,60,119,-4,50,29,-3,0,-5,3,-10,87,119,20,77,59,-3,2,5,4,-268,128,-9,-278,-43,-3,-2,-6,-4,150,118,18,140,59,-3,2,-2,1
CLEAN,393,15,-66,253,8,-70,-39,2,3,4,0,-4,-75,255,-6,-79,-65,-3,1,-3,1,308,235,18,304,43,2,2,6,6,-148,255,-7,-152,-65,-3,1,-1,1
IIFL,394,5,-48,219,18,-50,-48,2,3,4,5,-2,11,222,-18,9,38,-3,0,-3,-3,104,208,23,102,6,-3,0,0,0,-60,222,-16,-62,-12,-3,1,-3,3
PRAJIND,395,3,105,211,13,95,23,-3,0,-2,4,-10,76,216,16,66,57,-3,2,0,4,-236,218,-10,-246,-35,-3,-2,-6,-3,68,217,-6,58,42,-3,3,-3,1
TATAELXSI,396,-2,6,58,-4,3,3,1,2,-4,4,-3,81,56,18,78,60,-3,2,0,4,-164,59,-12,-167,-15,-3,-2,-5,-4,78,57,10,75,33,-3,1,-3,1
TVSMOTOR,397,-9,0,251,-6,-6,15,-3,-2,-5,1,-6,103,241,26,97,59,2,2,8,6,-268,256,-11,-274,-43,-3,-2,-5,-3,162,247,23,156,59,-3,2,0,0
INTELLECT,398,-12,6,375,-8,-9,15,-3,-2,-4,4,-15,95,370,19,80,59,2,2,7,6,-264,382,-16,-279,-43,-3,1,-5,0,166,368,20,151,60,-3,2,-1,5
BAJAJHLDNG,399,-15,-63,85,-10,-69,-9,-2,4,-4,0,-6,86,85,24,80,59,-3,2,1,3,-172,85,8,-178,-55,2,3,2,-3,140,83,16,134,59,-3,0,-2,0
TITAN,400,-18,54,26,-4,44,29,-2,0,-5,0,-10,88,22,21,78,59,-3,2,4,5,-292,29,-14,-302,-43,-3,-2,-6,-5,142,22,14,132,59,-3,2,-2,1
JBMA,401,-19,-69,124,-8,-84,-9,-2,4,-5,-3,-15,99,116,26,84,59,2,2,4,6,-188,123,3,-203,-55,2,3,0,0,154,119,21,139,60,-3,0,-2,1
FACT,402,-22,-39,316,-6,-44,-15,2,3,-1,4,-5,90,312,21,85,59,1,2,1,6,-204,316,-10,-209,-29,-3,-2,-5,-2,136,311,13,131,56,-3,1,-3,4
VIPIND,403,-22,42,56,16,39,-15,2,2,3,6,-3,7,59,-7,4,24,-3,-2,-5,0,16,56,-7,13,25,-3,-2,-5,-4,-84,62,-6,-87,-43,-2,4,1,4
GILLETTE,404,-42,15,410,-3,5,15,-2,-2,-3,0,-10,89,409,16,79,58,2,2,6,5,-280,410,-11,-290,-43,-3,-2,-6,-5,144,409,20,134,54,-3,0,-2,3
HDFCLIFE,405,-44,93,372,-3,92,41,-3,0,-4,0,-1,72,374,9,71,59,-2,2,1,3,-272,381,-12,-273,-43,-3,1,-7,-4,64,375,8,63,25,-2,3,-3,1
HEROMOTOCO,406,-45,-15,186,-7,-30,15,-3,-2,-5,-3,-15,95,185,19,80,59,2,2,7,6,-268,190,-10,-283,-43,-3,-2,-7,-2,158,185,21,143,59,-3,2,-1,1
MTARTECH,407,-48,6,438,18,7,-27,2,2,2,5,1,59,439,13,60,46,-3,0,-1,4,-68,439,16,-67,-19,-3,-2,-6,-3,-46,444,-10,-45,-10,-3,1,1,-2
ALOKINDS,408,-55,-42,473,-8,-44,-7,2,3,-4,0,-2,73,472,19,71,39,2,2,5,6,-236,476,-11,-238,-35,-3,1,-6,-5,152,466,18,150,59,-3,0,-1,3
KPITTECH,409,-60,-54,475,-10,-66,-15,2,2,-1,4,-12,92,468,24,80,60,-3,2,5,4,-220,475,-12,-232,-29,-3,-2,-6,-3,134,471,13,122,57,-3,3,-1,-2
MAPMYINDIA,410,-64,0,155,-5,-6,5,2,2,-2,-2,-6,60,158,16,54,38,-2,2,2,4,-184,154,-15,-190,-15,-3,-2,-6,-5,66,154,-7,60,42,-3,1,-3,3
ACC,411,-65,-9,60,-12,-21,15,-3,-2,-5,4,-12,96,54,16,84,65,2,2,6,5,-300,63,-16,-312,-43,-3,-2,-6,-5,160,50,16,148,59,-2,2,0,5
ABBOTINDIA,412,-72,-18,28,-10,-18,9,-2,1,-4,0,0,90,12,21,90,60,1,2,3,3,-292,28,-9,-292,-63,1,-2,-5,5,148,17,18,148,59,-3,2,-2,0
CIPLA,413,-73,-18,61,-10,-33,15,-3,-2,-4,-2,-15,94,55,19,79,59,2,2,7,5,-288,62,-16,-303,-43,-3,1,-6,-5,154,52,16,139,59,-3,2,-1,4
ASTRAL,414,-77,3,283,-7,-3,15,-3,-2,-3,1,-6,80,281,18,74,60,-3,2,3,0,-284,286,-12,-290,-43,-3,-2,-7,-4,130,279,6,124,60,-2,2,-1,0
RKFORGE,415,-79,-48,157,-8,-48,-15,2,1,0,4,0,87,151,23,87,59,-3,2,2,4,-208,155,-4,-208,-35,-2,-2,-6,-3,90,153,-10,90,55,-3,3,-3,3
BBTC,416,-82,-30,377,-4,-36,-9,2,1,-3,3,-6,88,369,13,82,59,2,2,6,6,-292,383,-8,-298,-61,-3,1,-1,-1,158,367,18,152,59,-3,0,0,5
JUBLFOOD,417,-82,-120,93,-6,-117,-47,2,3,4,4,3,-5,95,-10,-2,14,-3,-2,-4,0,172,75,15,175,13,2,2,8,3,-132,95,-13,-129,-45,-3,1,-3,-3
HONASA,418,-87,-39,442,-8,-48,-15,2,3,0,5,-9,-21,446,-9,-30,-5,-2,-2,-2,-1,-144,440,-11,-153,-33,2,4,-1,3,126,437,13,117,46,-2,3,0,3
HOMEFIRST,419,-98,-3,218,-5,-8,5,1,2,-4,0,-5,72,215,10,67,59,-3,2,0,4,-252,219,-16,-257,-35,-3,1,-6,-4,90,214,13,85,33,-2,1,-3,3
ITI,420,-101,-54,63,-10,-59,-15,2,3,-2,4,-5,92,50,19,87,59,2,2,4,6,-224,60,-8,-229,-35,-3,-2,-6,-2,90,53,-12,85,56,-3,3,-3,4
HSCL,421,-102,-78,350,-9,-87,-15,2,3,-5,-2,-9,93,337,21,84,58,2,2,4,6,-236,348,-10,-245,-35,-3,-2,-5,-4,128,344,16,119,52,-3,0,-1,0
CEATLTD,422,-105,9,314,-6,3,11,2,1,-5,0,-6,98,307,24,92,59,2,2,6,5,-356,320,-12,-362,-63,-3,-2,-5,-4,150,309,16,144,59,-3,0,-1,4
SYRMA,423,-106,-114,286,-11,-115,-36,2,4,2,1,-1,81,279,18,80,59,-2,2,0,4,-56,283,4,-57,-31,2,3,5,3,-16,282,-12,-17,14,-3,1,-4,-4
BSOFT,424,-118,-72,89,-11,-81,-9,2,-2,-4,0,-9,97,80,21,88,59,2,2,7,6,-288,94,-9,-297,-63,2,1,-6,3,154,81,20,145,60,-3,0,-1,1
CAPLIPOINT,425,-124,-81,317,-10,-87,-17,2,1,-1,-2,-6,93,310,20,87,59,1,2,5,6,-268,318,3,-274,-63,2,-2,-4,-3,138,310,18,132,51,-3,0,-1,4
MEDPLUS,426,-125,-60,474,-4,-57,-25,-2,2,4,5,3,-66,480,8,-63,-65,-2,-2,-3,-2,136,460,11,139,9,2,2,5,5,-138,479,-10,-135,-63,-2,4,1,1
MASTEK,427,-125,-78,189,-8,-84,-17,2,1,-1,-3,-6,83,186,18,77,60,-3,2,0,6,-252,188,-6,-258,-57,-3,1,-1,3,128,187,14,122,51,-3,0,-3,5
CAMPUS,428,-131,-66,378,4,-65,-39,2,3,5,3,1,-76,383,-11,-75,-59,-2,1,-4,-1,160,362,12,161,17,-2,2,7,4,-150,383,-8,-149,-66,-2,1,0,0
CERA,429,-133,-102,285,16,-107,-59,2,3,0,4,-5,68,282,18,63,53,-3,0,-1,1,-72,284,15,-77,-29,-3,1,-2,0,-22,283,-12,-27,7,-3,1,-4,0
GRANULES,430,-144,-9,411,-5,-19,9,-3,-2,-5,3,-10,89,410,15,79,59,2,2,6,5,-368,415,-14,-378,-63,-3,-2,-7,-3,154,408,16,144,59,-3,2,-1,4
BALRAMCHIN,431,-146,-27,84,13,-26,-25,2,2,-2,1,1,54,92,14,55,46,-3,0,-1,-2,-128,83,-15,-127,-9,-3,-2,-4,1,-46,93,-6,-45,-19,-2,4,2,-2
IDEA,432,-147,-102,379,-8,-112,-17,-2,1,-5,-3,-10,-11,379,15,-21,-34,2,2,3,1,-36,371,9,-46,-31,2,4,6,1,12,377,16,2,-1,-3,0,-4,-2
JYOTHYLAB,433,-147,-54,62,-8,-57,-15,2,3,-1,1,-3,94,47,24,91,59,2,2,2,5,-264,61,-8,-267,-55,-3,1,-2,1,80,56,-15,77,56,-3,3,-1,0
RECLTD,434,-149,-27,349,-8,-37,9,-3,-2,-5,0,-10,102,332,26,92,59,2,2,8,5,-376,352,-16,-386,-63,-3,-2,-6,-4,162,339,21,152,60,-3,2,0,1
RTNINDIA,435,-149,-75,90,-10,-84,-15,2,1,-5,2,-9,83,86,20,74,59,-3,2,0,5,-268,91,-15,-277,-45,-3,-2,-1,-1,120,85,14,111,51,-3,0,-3,1
DRREDDY,436,-150,-24,156,-7,-27,9,-3,-2,-5,0,-3,89,152,15,86,59,2,2,6,5,-360,160,-11,-363,-63,-3,-2,-6,-5,148,151,13,145,60,-3,2,-1,3
SWSOLAR,437,-152,-12,348,-10,-26,11,2,-2,-5,0,-14,60,347,16,46,30,2,2,5,5,-340,350,-8,-354,-63,-3,-2,-7,-2,154,341,18,140,59,-3,0,-2,5
BATAINDIA,438,-158,-147,254,-11,-138,-49,2,3,3,3,9,-12,254,-7,-3,7,-3,-2,-5,-2,172,244,17,181,11,2,2,6,5,-180,256,-15,-171,-65,-3,1,-4,-4
SUVENPHAR,439,-167,-96,125,-7,-103,-19,-3,-2,-4,3,-7,80,120,18,73,58,-3,2,0,5,-256,126,-10,-263,-61,2,4,1,0,112,121,14,105,44,-3,0,-3,4
SONATSOFTW,440,-170,-72,188,-10,-75,-9,1,1,-5,-2,-3,97,178,24,94,59,1,2,5,6,-332,191,-10,-335,-63,-3,1,-4,-4,140,186,16,137,54,-3,0,-1,4
TIINDIA,441,-177,-93,445,-8,-100,-11,-3,-2,-4,-3,-7,87,437,23,80,60,-3,2,1,4,-300,445,-10,-307,-63,2,1,-2,-3,136,435,16,129,54,-3,0,-2,3
NETWORK18,442,-188,-78,220,-11,-84,-18,2,1,-1,1,-6,42,221,18,36,15,1,2,0,6,-264,220,6,-270,-63,-3,1,-5,-2,118,213,16,112,43,-3,0,-3,6
CGCL,443,-191,-114,476,13,-116,-59,2,3,-1,4,-2,51,477,13,49,40,-3,0,-3,4,-100,473,12,-102,-29,-3,1,-4,-2,-26,477,-15,-28,3,-3,1,-5,6
EPL,444,-206,-141,126,4,-140,-59,2,2,0,4,1,46,124,3,47,39,2,0,-3,5,-112,119,6,-111,-29,-3,1,-4,1,0,125,3,1,7,-3,1,-4,-4
GLAXO,445,-207,-96,498,-11,-108,-17,2,1,-4,-3,-12,89,495,17,77,59,2,2,3,6,-304,501,3,-316,-63,-3,-2,-7,-4,116,494,13,104,51,-3,0,-4,1
ALLCARGO,446,-207,-75,87,7,-77,-39,2,3,-4,6,-2,66,89,14,64,54,-3,2,-1,0,-244,89,-13,-246,-35,-3,1,-6,-5,48,90,4,46,23,-3,0,-3,3
MPHASIS,447,-210,-72,88,-8,-78,-17,2,1,0,-2,-6,72,87,11,66,59,-3,2,-1,4,-268,90,-7,-274,-55,-3,1,-4,1,64,89,-3,58,43,-3,0,-3,-2
GAEL,448,-213,-51,412,-6,-54,-17,2,1,-1,4,-3,79,411,18,76,57,-3,2,0,5,-348,412,-10,-351,-63,-3,-2,-6,-3,110,411,13,107,44,-3,0,-3,4
HCLTECH,449,-217,-108,477,-13,-121,-11,-3,1,-7,-3,-13,96,467,21,83,60,2,2,7,4,-344,480,-10,-357,-63,-3,-2,-7,-1,152,470,18,139,59,-3,0,-1,3
RAMCOCEM,450,-223,-51,123,14,-48,-35,2,2,0,0,3,35,126,-3,38,40,-3,0,-3,4,-184,122,-4,-181,-29,-3,-2,-5,-3,-26,127,-13,-23,7,-3,1,-2,-3
KAJARIACER,451,-232,-165,382,-10,-163,-45,2,2,-1,-3,2,51,376,-3,53,54,-3,0,-1,4,-112,374,-8,-110,-19,-3,1,-3,4,-8,379,-12,-6,7,-3,1,-1,4
MRF,452,-244,-102,413,-16,-114,-11,-2,1,-6,0,-12,96,407,21,84,60,2,2,5,6,-364,414,-16,-376,-63,-3,-2,-5,-2,138,410,23,126,53,-3,0,-2,-2
GICRE,453,-244,-84,221,-8,-100,-17,2,1,-4,-2,-16,72,218,19,56,38,2,2,5,6,-356,223,-12,-372,-63,-3,1,-7,-5,140,211,18,124,54,-3,0,-2,3
BLUEDART,454,-246,-96,444,-7,-99,-33,2,2,4,0,-3,7,444,-8,4,24,-3,-2,-4,0,-16,438,-7,-19,-3,2,3,4,-3,-138,448,-14,-141,-45,-3,1,-4,-4
NIACL,455,-253,-60,86,-8,-72,-9,2,1,-4,-2,-12,41,93,19,29,6,2,2,6,6,-368,96,-13,-380,-63,-3,-2,-6,-5,146,82,23,134,54,-3,0,-2,1
WIPRO,456,-258,-120,351,-15,-135,-11,-3,-2,-6,-3,-15,83,341,12,68,60,2,2,2,5,-348,351,-9,-363,-63,-3,-2,-6,-4,142,342,20,127,53,-3,0,-2,3
TECHM,457,-289,-102,92,-10,-111,-19,2,1,-4,-4,-9,72,90,10,63,59,-3,2,-1,5,-344,95,-10,-353,-63,-3,-2,-4,-4,94,87,13,85,43,-3,0,-4,-2
COFORGE,458,-290,-99,191,-16,-108,-17,2,1,-3,0,-9,80,189,18,71,58,-3,2,0,5,-360,192,-12,-369,-63,-3,-2,-5,-5,98,188,11,89,44,-3,0,-3,0
PATANJALI,459,-297,-177,95,-13,-188,-41,2,1,-6,-2,-11,77,88,18,66,57,-3,2,-1,4,-184,87,13,-195,-61,-3,1,1,3,-2,92,-8,-13,20,-3,-2,-5,-3
INDIAMART,460,-305,-231,500,-8,-233,-63,-3,1,-1,-3,-2,54,498,10,52,46,-3,0,-3,4,-36,493,10,-38,-25,2,2,2,0,-90,500,-7,-92,-25,-3,-2,-4,-4
SHREECEM,461,-307,-69,443,4,-75,-25,1,0,-4,1,-6,60,440,3,54,54,1,2,-1,1,-320,447,-9,-326,-55,-3,-2,-6,-5,28,440,-7,22,23,-3,1,-3,3
KIMS,462,-320,-114,478,-11,-130,-19,2,-2,-6,-2,-16,82,473,19,66,58,-3,2,1,5,-332,479,-10,-348,-63,-3,-2,-6,1,60,474,-10,44,44,-3,0,-4,3
KAYNES,463,-324,-141,447,-13,-159,-19,-3,-2,-7,-3,-18,95,438,24,77,62,-2,2,3,6,-316,448,-15,-334,-63,2,1,-2,-2,56,439,-10,38,42,-3,0,-4,3
CENTURYPLY,464,-328,-126,414,-8,-132,-41,2,1,-1,5,-6,72,412,16,66,54,-3,2,-1,4,-280,409,-7,-286,-63,2,3,-3,-2,12,413,-11,6,23,-3,1,-4,0
ALKEM,465,-336,-129,222,-12,-135,-19,-3,-2,-4,-3,-6,91,211,19,85,59,2,2,4,5,-364,222,-13,-370,-63,-3,-2,-6,-4,72,216,-10,66,53,-3,0,-2,-2
JKLAKSHMI,466,-349,-204,352,-12,-220,-43,-3,-2,-5,-3,-16,79,343,18,63,58,-3,2,-1,5,-272,349,-6,-288,-63,2,4,-3,-2,64,347,-7,48,44,-3,0,-5,3
CCL,467,-351,-195,499,-7,-205,-61,2,4,-1,-2,-10,72,497,18,62,54,-3,0,-2,5,-180,498,11,-190,-61,2,2,-1,2,-38,499,-8,-48,3,-3,-2,-6,-3
TATATECH,468,-351,-18,59,13,-17,-27,2,2,1,3,1,-78,64,-13,-77,-58,-2,-2,-2,-1,-104,58,-4,-103,-9,-3,-2,-5,-3,-152,64,-13,-151,-63,-2,1,1,0
AFFLE,469,-355,-204,319,-11,-213,-59,2,3,-1,-2,-9,62,317,14,53,48,-3,0,-1,4,-192,315,-6,-201,-29,-3,-2,-5,-3,-12,316,-10,-21,13,-3,1,-3,-4
INFY,470,-361,-174,94,-13,-182,-41,2,4,-6,-4,-8,69,91,13,61,54,-3,2,-1,4,-272,92,-9,-280,-47,-3,0,-5,-4,24,91,-11,16,33,-3,0,-5,-2
3MINDIA,471,-368,-168,479,-8,-184,-43,2,-2,-6,1,-16,76,475,18,60,53,1,2,-2,4,-320,478,-9,-336,-63,-3,-2,-6,3,60,473,14,44,30,-3,-2,-5,-4
METROBRAND,472,-381,-174,128,-3,-181,-43,-3,-2,-4,-3,-7,78,122,21,71,53,-2,2,-1,5,-264,127,-10,-271,-61,2,4,1,-2,-14,126,-8,-21,10,-3,-2,-5,1
TV18BRDCST,473,-394,-174,30,-11,-183,-41,2,1,-6,-3,-9,39,27,18,30,13,1,2,-1,6,-296,30,-3,-305,-63,-3,1,-4,-2,46,26,-8,37,34,-3,-2,-4,6
KANSAINER,474,-398,-165,29,-13,-167,-47,2,3,0,0,-2,-27,31,-8,-29,-13,-3,-2,-4,3,-32,26,-8,-34,3,-3,2,-3,1,-172,31,-13,-174,-65,-3,1,-3,-3
DALBHARAT,475,-405,-186,384,-3,-195,-59,2,1,-5,2,-9,60,377,14,51,47,-3,0,-2,4,-244,379,-10,-253,-35,-3,-2,-6,-5,-26,380,-12,-35,7,-3,1,-4,-2
IBULHSGFIN,476,-413,-141,446,-8,-140,-39,2,2,-4,0,1,-33,448,7,-32,-47,1,2,0,4,-232,443,-8,-231,-35,-3,-2,-6,-4,-8,441,13,-7,-10,-3,1,-3,-2
ZFCVINDIA,477,-435,-198,160,-7,-208,-43,-3,-2,-6,-5,-10,81,155,20,71,57,-3,2,1,4,-328,158,-10,-338,-63,-3,-2,-6,2,20,156,-7,10,30,-3,-2,-5,-3
BRITANNIA,478,-436,-195,223,-8,-206,-43,-3,-2,-6,-3,-11,72,217,18,61,57,-3,2,0,-2,-340,221,-8,-351,-63,-3,-2,-6,-3,38,219,-9,27,43,-3,-2,-5,-5
GLAND,479,-477,-111,380,-10,-116,-17,2,-2,-5,-5,-5,-47,382,4,-52,-60,2,3,0,4,-316,384,-13,-321,-63,-3,1,-2,1,2,378,14,-3,-1,-3,0,-4,-5
ASIANPAINT,480,-478,-192,256,-10,-193,-59,2,3,0,0,-1,27,253,-3,26,38,-3,-2,-3,0,-224,255,-8,-225,-35,-3,-2,-5,-3,-88,253,-12,-89,-21,-3,1,-5,-4
PGHH,481,-485,-189,159,-7,-198,-43,-3,-2,-5,-3,-9,69,157,18,60,53,-3,2,-1,0,-332,159,-7,-341,-63,-3,1,-7,-4,-24,158,-10,-33,9,-3,-2,-4,-2
PEL,482,-490,-168,127,-7,-171,-59,2,3,0,5,-3,-35,128,-7,-38,-21,-3,-2,-5,3,-124,120,-8,-127,-15,-3,0,-3,-2,-160,128,-10,-163,-65,-3,1,-4,1
INDIGOPNTS,483,-498,-180,288,-8,-182,-55,2,3,0,-2,-2,-70,288,-8,-72,-65,2,1,-1,1,-88,285,4,-90,-29,-3,4,-1,3,-158,288,-6,-160,-65,-3,1,-4,-2
RAJESHEXPO,484,-517,-180,318,-7,-185,-56,2,3,0,-2,-5,-58,320,-10,-63,-36,-3,1,-6,-4,-116,313,-12,-121,-5,-3,-2,-5,-2,-158,320,-15,-163,-68,2,4,0,-2
LTIM,485,-521,-240,96,-15,-270,-61,2,4,-6,-4,-30,49,94,10,19,48,-3,0,-4,-2,-264,93,4,-294,-61,-3,-2,-5,1,-36,94,-10,-66,7,-3,-2,-6,-4
ANURAS,486,-530,-249,320,-12,-251,-63,-3,-2,-6,3,-2,55,316,9,53,47,-3,0,-2,4,-292,319,-12,-294,-63,2,3,-1,-2,-42,317,-13,-44,3,-3,-2,-5,-1
KRBL,487,-532,-192,480,-8,-197,-59,2,2,-1,0,-5,19,478,-7,14,28,-3,0,-3,4,-220,474,-13,-225,-29,-3,-2,-6,-2,-134,480,-12,-139,-45,-3,1,-5,-3
AWL,488,-532,-162,381,4,-161,-59,2,3,-4,0,1,-29,381,10,-28,-39,-2,1,-3,4,-224,377,-13,-223,-29,-3,-2,-4,-5,-118,382,8,-117,-70,2,1,0,0
STARHEALTH,489,-534,-174,255,-13,-177,-45,1,2,-4,1,-3,-85,256,-15,-88,-65,-2,1,-1,-3,-124,253,-8,-127,-9,-3,-2,-5,-4,-148,254,-12,-151,-69,2,4,0,1
VAIBHAVGBL,490,-567,-162,287,-13,-171,-42,2,1,-6,4,-9,26,286,10,17,16,-3,2,-3,4,-360,288,-13,-369,-63,-3,1,-7,-5,-62,285,-10,-71,-15,-3,-2,-4,3
TTML,491,-569,-222,31,-11,-231,-61,2,1,-5,0,-9,60,25,15,51,46,-3,0,-3,5,-324,31,-12,-333,-55,-3,-2,-6,-3,-74,30,-10,-83,-25,-3,1,-4,4
BERGEPAINT,492,-582,-165,448,10,-165,-63,2,-2,-3,1,0,-5,445,-8,-5,8,-3,-2,-4,4,-312,446,-7,-312,-63,2,-2,-5,-3,-100,447,4,-100,-49,-3,1,-4,1
ATGL,493,-617,-183,64,-6,-192,-53,2,1,-5,0,-9,3,60,-15,-6,18,-3,4,-2,1,-352,64,-9,-361,-63,-3,-2,-7,-4,-76,61,16,-85,-48,-3,0,-1,-2
NUVOCO,494,-653,-192,383,-10,-194,-59,2,3,0,0,-2,-81,384,-10,-83,-66,-3,-2,-3,3,-224,378,-7,-226,-35,-3,-2,-5,-4,-154,384,-6,-156,-65,-3,1,-5,1
MANYAVAR,495,-665,-216,192,-10,-226,-62,2,1,-1,-2,-10,-31,192,-10,-41,-10,-2,-2,-5,-2,-264,189,-7,-274,-63,2,3,-1,0,-144,192,-13,-154,-45,-3,1,-7,-5
ZEEL,496,-678,-174,158,-8,-176,-59,2,3,-1,5,-2,-88,160,-9,-90,-66,-3,-2,-6,-2,-232,157,-10,-234,-35,-3,-2,-6,-2,-182,160,-13,-184,-65,-3,1,-6,-5
HINDUNILVR,497,-775,-243,415,-16,-255,-63,2,1,-5,0,-12,-6,415,-7,-18,14,-3,-2,-5,-3,-360,413,-11,-372,-63,-3,-2,-6,-5,-154,415,-12,-166,-49,-3,-2,-7,-4
BANDHANBNK,498,-807,-237,501,-16,-243,-62,2,1,-2,-2,-6,-90,501,-9,-96,-68,-3,-2,-6,-2,-304,500,-14,-310,-63,-2,4,-4,3,-170,501,-8,-176,-65,-3,1,-5,-5
DABUR,499,-813,-285,416,-16,-330,-63,-3,-2,-7,-4,-45,-5,416,-7,-50,14,-3,-2,-5,-2,-336,416,-15,-381,-63,1,1,-6,-2,-142,416,-7,-187,-49,-3,-2,-5,-5
PAYTM,500,-870,-225,224,-8,-234,-64,1,1,-5,0,-9,-92,224,-13,-101,-68,-2,-2,-5,-2,-368,224,-14,-377,-63,-3,1,-8,-5,-176,224,-16,-185,-65,-3,4,-6,-2
RBA,501,-881,-267,32,-10,-283,-63,-3,-2,-6,-5,-16,-68,32,8,-84,-66,-3,-2,-6,1,-352,32,-15,-368,-63,-3,1,-7,-1,-178,32,-10,-194,-69,-3,-2,-6,1
