symbol,allRank,allPoints,d_IndicatorPoints,d_Rank,d_adxPoints,d_allPoints,d_emaPoints,d_kstPoints,d_macdPoints,d_rsiPoints,d_volumePoints,hl_BreakoutPoints,m_IndicatorPoints,m_Rank,m_adxPoints,m_allPoints,m_emaPoints,m_kstPoints,m_macdPoints,m_rsiPoints,m_volumePoints,min75_IndicatorPoints,min75_Rank,min75_adxPoints,min75_allPoints,min75_emaPoints,min75_kstPoints,min75_macdPoints,min75_rsiPoints,min75_volumePoints,w_IndicatorPoints,w_Rank,w_adxPoints,w_allPoints,w_emaPoints,w_kstPoints,w_macdPoints,w_rsiPoints,w_volumePoints
BEL,1,509,100,33,17,193,64,2,2,9,6,93,110,33,26,203,65,2,2,9,6,100,34,24,193,61,2,2,7,4,106,34,21,199,69,2,2,8,4
EXIDEIND,2,508,105,1,23,198,63,2,2,9,6,93,105,1,21,198,65,2,2,9,6,101,1,28,194,63,-2,2,9,1,104,2,21,197,69,-2,2,9,5
HINDZINC,3,507,106,225,25,199,62,2,2,9,6,93,98,227,17,191,66,2,2,8,3,105,225,26,198,63,2,2,6,6,105,225,18,198,69,2,2,9,5
KSB,4,505,97,449,16,189,63,2,2,8,6,92,110,449,26,202,65,2,2,9,6,108,449,26,200,63,2,2,9,6,98,451,18,190,69,-2,2,8,3
ABB,5,504,100,34,24,193,63,-3,2,8,6,93,110,34,26,203,65,2,2,9,6,92,35,17,185,61,2,2,6,4,109,33,21,202,69,2,2,9,6
MOTILALOFS,6,500,100,385,19,190,63,2,2,8,6,90,105,385,21,195,65,2,2,9,6,92,385,20,182,64,-2,2,4,4,113,385,24,203,70,2,2,9,6
KEI,7,499,99,289,17,192,63,2,2,9,6,93,108,289,24,201,65,2,2,9,6,99,289,21,192,63,2,2,7,4,100,290,16,193,69,2,2,8,3
TORNTPOWER,8,499,105,65,24,195,63,2,2,8,6,90,110,65,26,200,65,2,2,9,6,79,66,20,169,59,-3,2,0,1,115,65,26,205,70,2,2,9,6
AEGISCHEM,9,498,98,35,17,191,63,2,2,8,6,93,97,36,15,190,65,2,2,8,5,108,33,26,201,63,2,2,9,6,102,35,16,195,69,2,2,8,5
TATAPOWER,10,496,97,257,16,189,63,2,2,8,6,92,101,258,21,193,65,-2,2,9,6,98,257,24,190,63,2,2,2,5,108,257,23,200,69,2,2,8,4
THERMAX,11,493,106,226,24,193,63,2,2,9,6,87,110,225,26,197,65,2,2,9,6,80,226,19,167,59,-3,3,2,0,110,226,23,197,69,2,2,9,5
PHOENIXLTD,12,492,95,481,15,187,63,2,2,8,5,92,108,481,24,200,65,2,2,9,6,99,481,26,191,61,2,2,6,2,98,481,20,190,69,-2,2,8,1
CUMMINSIND,13,492,92,451,18,182,64,-2,2,5,5,90,110,450,28,200,65,2,2,9,4,92,451,15,182,63,2,2,5,5,108,449,24,198,65,2,2,9,6
SUNDARMFIN,14,490,98,3,17,189,63,2,2,8,6,91,105,2,21,196,65,2,2,9,6,88,3,23,179,63,-2,2,3,-1,108,1,24,199,69,2,2,8,3
HAL,15,488,99,322,17,177,64,2,2,8,6,78,112,321,28,190,65,2,2,9,6,91,322,18,169,61,-2,2,8,4,108,322,21,186,70,2,2,9,4
PETRONET,16,487,100,97,19,192,63,2,2,8,6,92,95,98,14,187,65,2,2,8,4,95,97,21,187,63,2,2,2,5,105,97,19,197,69,2,2,8,5
SAIL,17,486,97,450,16,189,63,2,2,8,6,92,100,451,16,192,65,2,2,9,6,94,450,21,186,61,-2,2,8,4,103,450,17,195,69,2,2,8,5
GODREJPROP,18,483,102,161,21,192,63,2,2,8,6,90,101,163,19,191,65,2,2,8,5,81,161,21,171,59,-3,2,1,1,109,161,23,199,69,2,2,8,5
MAHLIFE,19,481,100,321,19,190,63,2,2,8,6,90,99,322,21,189,65,-3,2,8,6,92,321,16,182,61,2,2,7,4,100,321,15,190,69,2,2,8,4
EICHERMOT,20,479,99,2,19,191,63,2,2,8,5,92,95,4,15,187,65,2,2,8,3,94,2,21,186,63,1,2,2,5,99,3,13,191,70,2,2,8,4
HINDCOPPER,21,478,98,66,16,188,63,2,2,9,6,90,85,68,23,175,44,2,2,9,5,97,65,26,187,64,-2,2,4,3,108,66,21,198,70,2,2,9,4
MCDOWELL-N,22,476,91,193,13,183,63,2,2,5,6,92,101,194,18,193,65,2,2,8,6,92,193,16,184,63,2,2,4,5,100,194,18,192,70,-2,2,8,4
KPIL,23,476,96,163,20,183,63,2,2,4,5,87,106,162,23,193,64,2,2,9,6,75,162,19,162,55,-3,2,-2,4,112,162,24,199,69,2,2,9,6
GAIL,24,474,95,417,16,184,63,2,2,7,5,89,105,417,21,194,65,2,2,9,6,74,418,19,163,55,-3,0,0,3,111,417,24,200,69,2,2,9,5
JSWENERGY,25,472,97,258,17,187,63,2,2,8,5,90,99,259,21,189,65,-3,2,9,5,78,258,21,168,55,-3,2,-1,4,108,258,21,198,69,2,2,9,5
BLUESTARCO,26,470,96,290,19,184,64,2,2,4,5,88,110,290,26,198,65,2,2,9,6,65,291,18,153,47,-3,0,-2,5,111,289,24,199,69,2,2,8,6
INDIGO,27,470,101,291,21,178,64,2,2,7,5,77,104,291,21,181,65,2,2,9,5,79,290,24,156,55,2,2,-2,-2,109,291,21,186,69,2,2,9,6
TATAMOTORS,28,469,88,130,13,173,63,-3,2,7,6,85,107,129,23,192,65,2,2,9,6,83,129,16,168,61,1,2,2,1,106,129,26,191,65,2,2,6,5
DIXON,29,467,101,323,19,173,64,2,2,8,6,72,106,323,23,178,65,2,2,8,6,79,323,18,151,55,2,2,-1,3,109,323,21,181,69,2,2,9,6
NTPC,30,466,98,259,17,185,63,2,2,8,6,87,110,257,26,197,65,2,2,9,6,69,259,21,156,55,-3,0,-2,-2,102,259,24,189,69,-3,2,5,5
HEG,31,465,103,354,21,157,63,2,2,9,6,54,97,355,15,151,65,2,2,8,5,104,353,24,158,64,2,2,8,4,107,354,21,161,69,2,2,8,5
"M&M",32,465,97,227,18,187,63,2,2,7,5,90,105,226,21,195,65,2,2,9,6,69,228,18,159,55,-3,0,0,-1,104,227,19,194,69,2,2,8,4
GLENMARK,33,465,98,228,16,173,63,2,2,9,6,75,102,228,19,177,65,2,2,9,5,88,227,21,163,61,-3,2,3,4,102,228,16,177,69,2,2,9,4
CENTURYTEX,34,463,97,162,17,187,63,2,2,7,6,90,105,161,21,195,65,2,2,9,6,63,163,18,153,49,-3,0,-2,1,108,163,21,198,69,2,2,8,6
BSE,35,460,99,260,19,173,63,2,2,7,6,74,110,260,26,184,65,2,2,9,6,74,260,18,148,55,-3,2,-1,3,103,262,21,177,70,-3,2,8,5
CASTROLIND,36,460,95,131,15,170,63,2,2,7,6,75,101,133,19,176,65,2,2,8,5,82,131,19,157,59,-3,2,1,4,107,131,21,182,69,2,2,8,5
BAJAJ-AUTO,37,460,85,5,18,164,62,-3,2,3,3,79,106,5,23,185,64,2,2,9,6,87,4,12,166,63,2,2,4,4,103,4,24,182,66,2,2,4,5
IRCTC,38,459,98,6,17,153,63,2,2,8,6,55,101,7,23,156,66,-3,2,8,5,100,5,21,155,63,2,2,7,5,105,6,21,160,69,2,2,8,3
VGUARD,39,457,92,129,12,179,63,2,2,7,6,87,97,130,15,184,65,2,2,8,5,78,130,21,165,55,-3,2,-1,4,103,130,15,190,70,2,2,8,6
SIEMENS,40,456,98,194,21,183,63,1,2,5,6,85,110,193,26,195,65,2,2,9,6,49,194,14,134,47,-3,-2,-3,-4,114,193,26,199,69,2,2,9,6
DATAPATTNS,41,454,97,69,16,146,63,2,2,8,6,49,100,70,21,149,65,-2,2,8,6,102,67,24,151,63,2,2,5,6,106,70,19,155,69,2,2,8,6
BHEL,42,451,95,418,13,182,64,2,2,8,6,87,87,419,23,174,45,2,2,9,6,83,417,16,170,59,2,2,0,4,99,418,21,186,69,-3,2,5,5
VEDL,43,448,105,419,23,150,63,2,2,9,6,45,85,420,10,130,66,-2,2,8,1,108,420,26,153,63,2,2,9,6,105,420,18,150,69,2,2,9,5
COCHINSHIP,44,447,97,482,17,167,63,2,2,7,6,70,110,482,26,180,65,2,2,9,6,61,482,20,131,47,-3,0,-2,-1,109,482,26,179,69,-3,2,9,6
TATAMTRDVR,45,445,87,166,13,169,63,-3,2,6,6,82,109,164,25,191,65,2,2,9,6,68,164,15,150,55,-3,2,-1,0,99,166,24,181,66,-3,2,5,5
ANANDRATHI,46,443,94,231,16,141,64,2,2,7,3,47,108,230,28,155,65,-2,2,9,6,97,230,21,144,63,2,2,8,1,97,231,24,144,65,-3,2,6,3
DMART,47,440,103,388,21,157,63,2,2,9,6,54,89,390,13,143,65,-2,2,8,3,86,386,19,140,61,-3,2,3,4,108,389,21,162,69,2,2,9,5
IPCALAB,48,440,97,324,16,151,63,2,2,8,6,54,101,324,19,155,65,2,2,8,5,85,324,20,139,59,-2,2,1,5,103,324,20,157,69,-2,2,8,6
MUTHOOTFIN,49,439,104,99,24,153,63,2,2,7,6,49,98,101,17,147,65,2,2,8,4,86,98,19,135,61,-3,2,4,3,102,101,17,151,69,2,2,8,4
JUBLINGREA,50,437,99,230,17,143,63,2,2,9,6,44,90,231,13,134,66,-2,2,6,5,105,229,24,149,64,2,2,7,6,99,232,14,143,69,2,2,7,5
PNB,51,432,95,261,15,169,64,2,2,6,6,74,86,262,23,160,44,2,2,9,6,73,261,16,147,55,-3,2,-2,5,104,261,24,178,66,2,2,5,5
BHARTIARTL,52,430,62,421,-4,142,61,-2,2,2,3,80,106,418,21,186,66,2,2,9,6,82,419,14,162,63,2,2,3,-2,100,419,24,180,65,1,2,4,4
ICICIBANK,53,430,79,132,6,159,63,-2,2,6,4,80,96,132,18,176,66,-3,2,8,5,74,132,14,154,61,-3,0,2,0,101,132,18,181,66,2,2,8,5
VTL,54,423,96,167,15,138,63,2,2,8,6,42,92,167,10,134,65,2,2,8,5,96,165,17,138,63,2,2,8,4,97,167,11,139,69,2,2,8,5
INDHOTEL,55,423,68,67,-7,156,64,-2,2,6,5,88,110,66,26,198,65,2,2,9,6,53,68,-15,141,61,2,2,5,-2,104,67,21,192,65,2,2,9,5
VOLTAS,56,422,99,356,19,141,63,2,2,7,6,42,97,356,16,139,65,2,2,8,4,73,355,20,115,55,-3,0,0,1,111,355,23,153,69,2,2,9,6
360ONE,57,422,97,358,16,112,63,2,2,8,6,15,106,357,24,121,65,2,2,8,5,102,354,24,117,63,2,2,7,4,102,357,21,117,69,-2,2,8,4
NATIONALUM,58,418,95,164,17,181,63,2,2,5,6,86,103,165,19,189,65,2,2,9,6,29,166,-8,115,47,-3,0,-4,-3,105,164,19,191,69,2,2,8,5
JINDALSTEL,59,416,91,386,15,176,64,2,2,4,4,85,102,386,19,187,65,2,2,9,5,33,388,-5,118,47,-3,1,-3,-4,105,386,19,190,69,2,2,8,5
JBCHEPHARM,60,416,98,9,16,113,63,2,2,9,6,15,104,10,24,119,65,-2,2,9,6,101,6,19,116,63,2,2,9,6,98,10,17,113,69,-2,2,8,4
MAXHEALTH,61,415,98,266,17,113,63,2,2,8,6,15,105,265,26,120,65,-2,2,9,5,100,265,21,115,63,2,2,7,5,97,266,16,112,69,2,2,8,0
ASTERDM,62,413,95,422,17,108,63,2,2,8,3,13,103,423,19,116,65,2,2,9,6,100,422,26,113,63,-3,2,8,4,102,422,24,115,69,-2,2,5,4
NUVAMA,63,413,103,264,21,139,63,2,2,9,6,36,86,263,18,122,65,-2,2,1,2,99,263,20,135,63,2,2,8,4,89,265,17,125,59,-2,2,9,4
ICICIPRULI,64,412,100,293,18,149,64,2,2,8,6,49,91,294,9,140,66,2,2,7,5,73,293,18,122,55,-3,2,-2,3,99,294,14,148,69,2,2,8,4
REDINGTON,65,412,88,262,13,168,63,2,2,3,5,80,96,261,19,176,66,-3,2,8,4,48,264,13,128,39,-3,0,-4,3,100,260,18,180,65,2,2,8,5
HONAUT,66,410,101,294,19,146,63,2,2,9,6,45,85,295,10,130,66,-2,2,6,3,87,292,23,132,59,-3,2,1,5,92,295,14,137,61,2,2,8,5
BRIGADE,67,407,96,395,16,106,63,2,2,7,6,10,108,393,24,118,65,2,2,9,6,95,392,21,105,63,2,2,4,3,98,395,20,108,69,-3,2,5,5
CANBK,68,407,90,4,13,171,64,2,2,4,5,81,109,3,26,190,64,2,2,9,6,29,7,-7,110,39,-3,0,-4,4,98,5,19,179,66,2,2,4,5
AARTIIND,69,405,98,420,17,143,63,2,2,8,6,45,77,421,16,122,45,2,2,7,5,101,421,19,146,63,2,2,9,6,84,421,19,129,48,2,2,8,5
NAM-INDIA,70,405,98,198,17,112,63,2,2,8,6,14,102,197,19,116,65,2,2,8,6,88,198,24,102,59,-3,2,1,5,103,197,24,117,69,-2,2,5,5
CDSL,71,404,92,298,14,107,63,2,2,8,3,15,100,296,21,115,66,-2,2,8,5,103,294,21,118,63,2,2,9,6,94,298,19,109,69,-3,2,4,3
GPIL,72,403,97,484,16,111,63,2,2,8,6,14,94,486,21,108,59,-3,2,9,6,99,483,21,113,63,2,2,5,6,99,485,19,113,69,-3,2,8,4
RADICO,73,403,96,199,16,111,63,2,2,8,5,15,98,199,21,113,65,-2,2,8,4,95,195,17,110,63,2,2,7,4,99,198,18,114,69,-2,2,8,4
ZOMATO,74,402,98,229,19,149,63,2,2,7,5,51,74,232,19,125,36,2,2,9,6,70,231,16,121,55,-3,0,-1,3,109,230,21,160,70,2,2,9,5
MANAPPURAM,75,402,97,391,16,141,63,2,2,8,6,44,91,391,11,135,65,2,2,7,4,72,389,21,116,55,-3,2,-1,-2,98,391,16,142,69,-2,2,8,5
ABCAPITAL,76,401,97,387,17,169,63,2,2,7,6,72,75,389,18,147,45,-2,2,8,4,61,387,18,133,49,-3,2,-1,-4,96,388,12,168,69,2,2,7,4
KALYANKJIL,77,401,95,355,15,147,64,2,2,6,6,52,108,354,24,160,65,2,2,9,6,45,357,-11,97,47,2,3,4,0,101,356,23,153,70,-3,2,5,4
TRENT,78,400,88,172,15,97,63,-2,2,7,3,9,112,168,28,121,65,2,2,9,6,92,171,17,101,63,2,2,7,1,99,170,24,108,65,-3,2,6,5
GRAPHITE,79,395,87,8,16,133,61,2,2,0,6,46,99,8,16,145,65,2,2,8,6,55,8,21,101,39,-3,0,-5,3,108,8,23,154,69,2,2,8,4
CHALET,80,393,98,203,18,101,63,2,2,7,6,3,108,201,24,111,65,2,2,9,6,82,202,9,85,63,2,2,4,2,102,201,24,105,70,-3,2,4,5
TATASTEEL,81,393,93,165,16,177,64,2,2,4,5,84,95,166,17,179,65,-2,2,8,5,16,172,-10,100,39,-3,-2,-4,-4,105,165,19,189,69,2,2,8,5
"ARE&M",82,391,98,201,17,105,63,2,2,8,6,7,93,204,18,100,64,2,2,7,0,97,197,26,104,63,-3,2,5,4,96,202,17,103,69,-2,2,7,3
JIOFIN,83,390,92,71,19,117,61,-3,2,8,5,25,85,72,18,110,64,-2,2,1,2,88,69,21,113,61,-3,2,2,5,100,71,26,125,55,2,2,9,6
KARURVYSYA,84,388,93,171,14,102,63,2,2,6,6,9,107,169,24,116,65,2,2,9,5,80,175,18,89,61,-3,0,1,3,99,169,23,108,69,-3,2,4,4
JINDALSAW,85,388,95,169,15,107,63,2,2,7,6,12,97,171,24,109,59,2,2,4,6,91,169,16,103,61,2,2,6,4,93,173,16,105,70,-3,2,4,4
MCX,86,386,96,170,16,105,63,2,2,7,6,9,103,170,19,112,65,2,2,9,6,81,174,21,90,55,1,2,-2,4,97,172,19,106,70,-3,2,5,4
BEML,87,386,95,136,16,106,63,2,2,6,6,11,102,134,19,113,65,2,2,8,6,81,136,24,92,55,-3,2,-1,4,97,138,21,108,69,-3,2,4,4
CESC,88,385,99,297,19,110,63,2,2,7,6,11,99,297,17,110,65,2,2,8,5,78,300,23,89,55,-3,2,0,1,98,297,19,109,69,-3,2,8,3
POONAWALLA,89,385,87,140,11,96,63,2,2,5,4,9,98,136,21,107,65,-3,2,8,5,86,135,16,95,61,-3,2,6,4,105,135,20,114,69,2,2,7,5
SRF,90,384,92,232,13,124,63,2,2,7,5,32,88,233,15,120,66,-3,2,7,1,73,232,16,105,55,2,2,-2,0,99,233,13,131,69,2,2,8,5
SCHNEIDER,91,384,87,98,21,169,59,1,2,-1,5,82,112,97,28,194,65,2,2,9,6,-5,105,-8,77,15,-3,-2,-6,-1,108,98,26,190,69,2,2,4,5
"M&MFIN",92,384,97,102,16,124,63,2,2,8,6,27,89,103,14,116,65,-3,2,7,4,83,99,23,110,59,-3,2,1,1,88,102,5,115,69,2,2,6,4
TATACHEM,93,382,89,392,16,123,63,-2,2,5,5,34,96,392,19,130,66,-3,2,7,5,65,395,18,99,55,-3,0,-2,-3,98,392,16,132,69,2,2,5,4
POWERINDIA,94,382,94,100,21,149,63,2,2,1,5,55,110,100,26,165,65,2,2,9,6,15,109,-13,70,39,-3,0,-5,-3,108,100,21,163,69,2,2,9,5
INOXWIND,95,381,93,487,15,97,63,2,2,5,6,4,90,492,26,94,45,2,2,9,6,99,484,21,103,63,2,2,7,4,95,488,19,99,69,-3,2,5,3
IRB,96,381,96,11,16,106,64,2,2,6,6,10,110,9,26,120,65,2,2,9,6,64,15,24,74,47,-3,0,-2,-2,101,11,19,111,69,-3,2,8,6
INDUSTOWER,97,380,100,263,19,152,63,2,2,8,6,52,51,270,16,103,17,2,2,8,6,89,262,21,141,61,-2,2,4,3,88,263,21,140,49,2,2,9,5
HINDALCO,98,380,97,135,16,111,63,2,2,8,6,14,89,142,16,103,65,-3,2,6,3,86,134,21,100,59,2,2,0,2,94,137,17,108,70,-3,2,7,1
VIJAYA,99,378,94,168,13,109,63,2,2,8,6,15,69,184,16,84,38,2,2,7,4,96,168,15,111,63,2,2,8,6,104,168,23,119,69,-3,2,8,5
EIDPARRY,100,377,94,424,15,101,63,2,2,7,5,7,89,430,14,96,65,-3,2,5,6,93,423,18,100,63,1,2,4,5,94,424,17,101,69,-3,2,6,3
NAUKRI,101,374,94,390,17,143,63,2,2,5,5,49,99,388,17,148,65,2,2,8,5,28,400,-13,77,47,-3,0,-3,0,104,390,19,153,69,2,2,8,4
CONCORDBIO,102,373,99,296,19,112,63,2,2,7,6,13,86,301,18,99,65,-2,2,1,2,85,298,19,98,61,2,2,-1,2,90,300,23,103,59,-3,2,5,4
NMDC,103,373,97,299,16,106,63,2,2,8,6,9,81,308,19,90,44,2,2,9,5,92,297,21,101,61,2,2,1,5,94,299,21,103,69,-3,2,5,0
JUSTDIAL,104,371,95,454,17,100,63,2,2,5,6,5,96,459,15,101,65,2,2,6,6,69,455,19,74,49,-3,2,-1,3,106,454,19,111,70,2,2,7,6
SCHAEFFLER,105,371,96,197,17,114,63,2,2,8,4,18,96,198,24,114,66,-3,2,4,3,72,200,9,90,61,-3,2,0,3,89,200,9,107,69,2,2,6,1
COALINDIA,106,371,82,174,4,91,63,2,2,6,5,9,89,176,26,98,44,2,2,9,6,93,170,16,102,63,2,2,4,6,98,171,24,107,66,-3,2,5,4
DOMS,107,369,96,393,19,118,63,2,2,4,6,22,86,395,18,108,65,-2,2,1,2,79,394,20,101,55,-3,2,0,5,86,394,15,108,59,-2,2,8,4
ADANIPOWER,108,368,84,195,16,168,61,2,2,-1,4,84,100,195,21,184,65,-2,2,8,6,3,201,-9,87,25,-3,-2,-5,-3,97,195,19,181,70,-3,2,4,5
GODREJIND,109,366,93,137,16,102,63,2,2,4,6,9,103,135,21,112,65,2,2,7,6,63,138,20,72,47,-3,0,-1,0,98,139,21,107,69,-3,2,5,4
LICHSGFIN,110,365,96,106,17,100,63,2,2,7,5,4,99,105,16,103,65,2,2,8,6,67,107,16,71,55,-3,2,-1,-2,99,105,21,103,69,-3,2,5,5
MAZDOCK,111,364,87,173,16,96,55,2,2,6,6,9,98,172,26,107,59,1,2,4,6,77,176,23,86,55,-3,0,-1,3,93,174,18,102,67,-3,2,6,3
POLYCAB,112,363,97,394,16,113,63,2,2,8,6,16,90,398,24,106,59,-3,2,4,4,72,396,13,88,59,-2,2,-1,1,88,396,11,104,70,-2,2,7,0
UBL,113,362,92,423,14,104,63,2,2,8,3,12,91,425,15,103,65,-3,2,7,5,73,425,11,85,59,-2,2,0,3,94,423,14,106,69,-2,2,7,4
MEDANTA,114,362,94,235,15,101,64,2,2,6,5,7,100,235,24,107,64,-2,2,6,6,67,236,16,74,55,-3,2,0,-3,94,236,24,101,60,-2,2,5,5
BAJAJFINSV,115,361,94,325,15,112,63,2,2,7,5,18,82,328,8,100,65,-3,2,6,4,74,327,18,92,55,-3,2,-1,3,93,325,11,111,69,2,2,6,3
NSLNISP,116,361,94,105,15,103,63,2,2,6,6,9,94,106,19,103,65,-2,2,4,6,81,104,21,90,59,-3,2,-1,3,83,110,16,92,59,-2,2,7,1
SOBHA,117,361,95,40,16,101,64,2,2,6,5,6,102,37,19,108,64,2,2,9,6,57,48,16,63,49,-3,0,-2,-3,101,38,23,107,69,-3,2,5,5
LINDEINDIA,118,360,77,389,16,157,59,-3,2,0,3,80,102,387,24,182,65,-3,2,9,5,-3,401,-8,77,15,-3,-2,-3,-2,104,387,17,184,69,2,2,8,6
CAMS,119,360,82,331,6,87,63,2,2,5,4,5,96,327,14,101,65,2,2,7,6,84,328,16,89,59,2,2,2,3,93,326,18,98,69,-3,2,3,4
BDL,120,360,79,50,3,79,63,2,2,4,5,0,108,38,24,108,65,2,2,9,6,84,41,16,84,59,2,2,2,3,89,49,18,89,65,-3,2,3,4
ELGIEQUIP,121,360,76,47,13,83,49,2,2,4,6,7,98,41,20,105,65,-3,2,8,6,86,39,12,93,63,2,2,3,4,93,40,18,100,65,2,2,2,4
TRITURBINE,122,358,85,452,18,162,59,2,2,0,4,77,97,452,18,174,65,-2,2,8,6,-5,456,-9,72,15,-2,-2,-5,-2,104,452,17,181,69,2,2,8,6
LODHA,123,358,85,425,9,91,63,2,2,5,4,6,105,424,21,111,65,2,2,9,6,67,427,18,73,49,-2,0,-1,3,95,426,18,101,69,-3,2,4,5
WELCORP,124,357,90,455,15,99,63,2,2,3,5,9,101,454,24,110,59,2,2,8,6,67,454,11,76,59,-3,2,1,-3,90,459,16,99,70,-3,2,2,3
FDC,125,357,80,400,3,82,63,2,2,5,5,2,101,400,18,103,65,2,2,8,6,75,399,14,77,61,-3,0,2,1,99,398,23,101,69,-3,2,3,5
USHAMART,126,357,96,200,16,105,63,2,2,7,6,9,89,206,23,98,60,-3,2,3,4,75,203,7,84,61,-2,2,2,5,88,205,8,97,70,-2,2,6,4
ACE,127,357,71,36,13,156,55,-3,2,-1,5,85,112,35,28,197,65,2,2,9,6,-14,46,-15,71,9,-3,1,-3,-3,103,36,24,188,65,2,2,4,6
UTIAMC,128,356,90,270,14,99,63,2,2,7,2,9,85,275,11,94,65,-3,2,5,5,72,270,13,81,61,-3,2,2,-3,100,268,19,109,69,-2,2,7,5
QUESS,129,354,103,37,21,148,63,2,2,9,6,45,17,57,6,62,-4,2,3,6,4,106,36,26,151,63,2,2,8,5,83,37,17,128,48,2,2,9,5
APARINDS,130,353,85,353,16,161,61,2,2,-1,5,76,102,353,24,178,59,2,2,9,6,-8,361,-11,68,15,-3,-2,-5,-2,98,353,20,174,70,-2,2,4,4
METROPOLIS,131,353,97,133,16,142,63,2,2,8,6,45,41,153,3,86,25,2,3,6,2,96,133,23,141,63,2,2,2,4,74,134,14,119,49,-2,2,7,4
PNCINFRA,132,351,90,239,16,88,63,2,2,3,4,-2,101,239,18,99,66,2,2,8,5,64,241,15,62,47,-3,3,1,1,98,237,16,96,65,2,2,8,5
NBCC,133,350,90,142,15,91,63,2,2,3,5,1,104,138,21,105,64,2,2,9,6,58,144,16,59,47,-3,0,-2,0,97,145,24,98,65,-3,2,3,6
MSUMI,134,347,91,139,13,96,63,2,2,5,6,5,91,146,13,96,65,-2,2,8,5,66,139,12,71,45,-3,3,5,4,94,141,11,99,70,2,2,5,4
DEEPAKNTR,135,346,63,178,16,78,29,2,2,8,6,15,87,173,15,102,66,-3,2,2,5,99,167,19,114,63,2,2,8,5,82,176,7,97,67,-3,2,6,3
NLCINDIA,136,346,84,45,8,84,63,2,2,4,5,0,98,44,24,98,59,2,2,8,3,72,45,18,72,55,-2,2,-2,1,92,47,18,92,70,-3,2,4,1
PIDILITIND,137,345,78,292,16,153,59,-3,2,-1,5,75,93,293,16,168,65,-2,2,8,4,-4,305,-4,71,15,-3,-2,-6,-4,103,292,19,178,69,2,2,8,3
LUPIN,138,344,67,402,8,67,47,-2,3,5,6,0,99,402,21,99,59,2,2,9,6,80,397,15,80,61,2,2,2,-2,98,401,24,98,66,-3,2,4,5
RRKABEL,139,344,93,103,14,111,63,2,2,7,5,18,81,109,13,99,65,-2,2,1,2,75,103,7,93,61,2,2,2,1,77,108,9,95,60,-2,2,8,0
GRSE,140,341,92,42,15,99,63,2,2,4,6,7,93,43,21,100,59,1,2,4,6,55,49,18,62,47,-3,0,-4,-3,94,39,14,101,70,-3,2,6,5
CONCOR,141,340,91,269,13,100,63,2,2,5,6,9,97,268,16,106,65,2,2,7,5,51,272,-7,60,55,-3,2,-1,5,92,270,16,101,69,-3,2,4,4
EIHOTEL,142,340,91,236,18,100,63,2,2,1,5,9,106,234,23,115,64,2,2,9,6,24,246,-8,33,39,-2,0,-5,0,110,234,26,119,65,2,2,9,6
FORTIS,143,340,86,73,13,92,63,2,2,3,3,6,96,75,21,102,60,2,2,8,3,62,73,18,68,47,-3,0,-3,3,90,75,19,96,69,-3,2,3,0
CIEINDIA,144,339,87,72,15,99,55,2,2,8,5,12,84,76,20,96,59,-3,2,3,3,88,70,15,100,61,-2,2,7,5,68,79,10,80,53,-2,3,6,-2
LLOYDSME,145,337,98,453,17,133,63,2,2,8,6,35,17,476,16,52,-3,-2,3,1,2,99,452,24,134,63,2,2,2,6,88,453,13,123,59,2,2,8,4
IDFC,146,337,70,397,17,90,35,2,2,8,6,20,87,396,21,107,59,-3,2,4,4,88,390,21,108,61,-2,2,1,5,72,402,13,92,54,-2,3,6,-2
MFSL,147,335,90,202,11,105,63,2,2,6,6,15,97,200,16,112,65,2,2,7,5,39,208,-12,54,49,1,2,-2,1,94,199,13,109,70,-2,2,7,4
RITES,148,334,66,362,4,71,49,2,2,4,5,5,103,358,21,108,65,2,2,7,6,69,358,11,74,47,2,2,4,3,91,359,20,96,65,-3,2,2,5
FEDERALBNK,149,334,82,240,6,86,63,2,2,5,4,4,92,242,16,96,65,-3,2,8,4,65,238,9,69,55,-3,2,-1,3,91,238,13,95,70,-3,2,6,3
MARUTI,150,334,79,68,20,151,56,-2,2,-2,5,72,98,69,17,170,65,2,2,8,4,-14,75,-14,58,15,-3,-2,-5,-5,99,68,19,171,65,2,2,7,4
KEC,151,333,95,267,19,111,63,2,2,3,6,16,105,264,21,121,66,2,2,8,6,8,280,-8,24,25,-3,-2,-4,0,109,264,23,125,69,2,2,8,5
NHPC,152,332,79,108,3,83,63,2,2,3,6,4,110,104,26,114,65,2,2,9,6,47,111,10,51,39,-2,0,-4,4,92,107,21,96,66,-2,2,4,1
JAIBALAJI,153,331,68,401,10,75,43,2,3,6,4,7,98,399,26,105,58,2,2,4,6,66,402,18,73,43,-3,2,3,3,92,399,21,99,66,-3,2,3,3
RAYMOND,154,331,91,41,14,99,63,2,2,4,6,8,94,42,21,102,65,-3,2,5,4,51,50,16,59,39,-3,0,-4,3,87,44,3,95,70,2,2,6,4
CSBBANK,155,330,84,328,14,93,55,2,2,6,5,9,90,329,16,99,59,2,2,6,5,61,332,18,70,47,-3,0,-4,3,86,328,13,95,70,-3,2,3,1
SBIN,156,328,80,427,10,84,63,2,2,0,3,4,96,426,19,100,65,-3,2,8,5,51,432,7,55,49,-3,2,-4,0,97,425,17,101,65,2,2,7,4
GUJGASLTD,157,327,70,303,-6,77,63,2,2,4,5,7,87,305,12,94,66,-2,2,6,3,69,304,7,76,61,-3,0,1,3,94,301,15,101,64,2,2,6,5
ADANIPORTS,158,327,65,70,9,137,57,1,2,-2,-2,72,106,67,21,178,66,2,2,9,6,-14,74,-10,58,9,-3,-2,-6,-2,98,69,21,170,65,2,2,4,4
CENTRALBK,159,325,82,489,8,86,63,2,2,2,5,4,87,493,26,91,44,2,2,8,5,58,486,14,62,47,-3,0,-3,3,94,489,21,98,66,-3,2,3,5
RAINBOW,160,325,91,141,18,95,63,2,2,3,3,4,99,141,23,103,65,-2,2,6,5,22,149,7,26,25,-2,-2,-4,-2,109,136,24,113,69,2,2,7,5
SAPPHIRE,161,325,83,138,11,99,63,-2,2,6,3,16,85,144,8,101,65,-2,2,7,5,51,141,10,67,29,2,2,7,1,90,140,7,106,69,2,2,6,4
BORORENEW,162,324,74,18,4,78,57,2,2,4,5,4,81,18,13,85,65,-3,2,4,0,71,14,9,75,55,2,2,-1,4,94,14,11,98,69,2,2,5,5
SYNGENE,163,323,70,399,17,85,35,2,2,8,6,15,82,404,16,97,59,-2,2,2,5,91,391,19,106,63,2,2,0,5,65,406,6,80,45,2,3,6,3
GRASIM,164,323,58,196,-4,133,55,2,2,-1,4,75,98,196,19,173,66,-3,2,8,6,8,204,-7,83,29,-3,-2,-6,-3,84,196,16,159,65,-3,2,3,1
TATAINVEST,165,323,48,114,12,52,36,-3,3,-1,1,4,112,102,28,116,65,2,2,9,6,59,110,10,63,45,-3,3,1,3,100,104,23,104,65,2,2,2,6
FSL,166,322,67,144,-10,70,63,2,2,5,5,3,96,145,18,99,60,2,2,8,6,61,142,13,64,49,-2,2,-2,1,95,143,18,98,69,-3,2,4,5
HUDCO,167,321,86,459,11,87,62,2,2,3,6,1,110,453,26,111,65,2,2,9,6,25,466,-10,26,39,-3,0,-2,1,99,458,24,100,65,-2,2,5,5
GODFRYPHLP,168,321,56,134,13,128,50,-3,0,-4,0,72,109,131,26,181,65,2,2,9,5,-13,145,12,59,-19,-3,1,-5,1,97,133,24,169,65,2,2,1,3
DLF,169,320,85,74,15,88,63,2,2,0,3,3,107,71,23,110,65,2,2,9,6,28,79,11,31,25,-3,-2,-4,1,97,73,24,100,66,-3,2,4,4
GLS,170,320,86,16,10,84,63,2,2,3,6,-2,73,23,20,71,38,2,2,6,5,70,16,14,68,55,-3,0,1,3,93,15,20,91,65,-2,2,3,5
LTTS,171,319,89,271,16,98,61,2,2,3,5,9,96,269,18,105,66,-3,2,8,5,28,277,-7,37,39,-3,3,-1,-3,97,269,20,106,69,-2,2,4,4
ESCORTS,172,319,89,237,18,98,55,2,2,6,6,9,86,244,20,95,59,-3,2,4,4,60,239,13,69,49,-3,0,-2,3,75,245,12,84,54,-3,3,6,3
HFCL,173,319,60,244,4,67,43,2,2,5,4,7,93,238,16,100,66,-3,2,6,6,71,235,16,78,41,2,2,5,5,88,239,18,95,65,-3,2,2,4
ASHOKLEY,174,319,87,13,15,98,55,2,2,7,6,11,75,17,14,86,59,-3,2,3,0,78,11,14,89,61,-2,2,0,3,68,17,6,79,55,-2,3,6,0
GPPL,175,318,73,75,6,73,64,-3,2,0,4,0,105,73,21,105,65,2,2,9,6,40,78,15,40,25,2,1,-4,1,100,72,18,100,65,2,2,7,6
GSPL,176,317,90,456,14,93,63,2,2,3,6,3,98,458,16,101,65,2,2,8,5,24,464,-13,27,39,-3,0,-4,5,102,455,18,105,69,2,2,7,4
TATACONSUM,177,317,45,405,-10,54,41,2,3,5,4,9,103,394,21,112,66,2,2,7,5,70,398,16,79,43,2,2,4,3,90,400,20,99,65,-3,2,2,4
POLICYBZR,178,316,92,7,19,138,63,2,2,1,5,46,41,14,17,87,11,-2,2,7,6,49,9,18,95,39,-3,0,-2,-3,88,9,21,134,49,2,2,9,5
ASAHIINDIA,179,315,99,234,21,111,63,2,2,5,6,12,92,236,18,104,65,-3,2,6,4,20,247,-10,32,39,-3,0,-4,-2,92,235,8,104,69,2,2,6,5
APOLLOHOSP,180,313,76,490,8,75,61,2,2,2,1,-1,99,489,21,98,66,-3,2,8,5,49,487,7,48,47,-3,0,-3,1,90,491,18,89,65,-3,2,3,5
MOTHERSON,181,313,88,327,13,93,63,2,2,5,3,5,58,342,13,63,31,2,2,7,3,83,329,13,88,61,2,2,2,3,79,335,16,84,45,2,2,8,6
UNOMINDA,182,313,95,10,18,107,63,2,2,4,6,12,96,11,18,108,66,-3,2,8,5,15,24,-15,27,39,-3,0,-5,-1,95,12,15,107,70,-2,2,7,3
SJVN,183,310,80,426,6,89,62,2,2,3,5,9,110,422,26,119,65,2,2,9,6,20,434,7,29,25,-3,-2,-4,-3,91,427,19,100,65,-3,2,4,4
IDFCFIRSTB,184,310,60,305,17,74,29,2,2,7,3,14,84,302,18,98,60,-3,2,3,4,94,296,19,108,63,2,2,2,6,58,309,10,72,43,-2,1,5,1
ENDURANCE,185,310,82,273,10,88,61,2,2,2,5,6,90,272,19,96,59,1,2,5,4,46,274,18,52,39,-3,0,-4,-4,86,273,16,92,70,-3,2,1,0
MGL,186,310,87,241,15,82,61,2,2,2,5,-5,98,246,17,93,65,2,2,7,5,35,248,-7,30,47,-3,0,-3,1,95,242,16,90,69,2,2,3,3
ZENSARTECH,187,310,81,175,18,87,59,-3,2,0,5,6,95,175,19,101,59,2,2,8,5,37,179,4,43,31,-2,3,-3,4,91,175,18,97,69,-3,2,2,3
AVANTIFEED,188,310,80,46,3,84,63,2,2,4,6,4,85,49,10,89,59,2,2,6,6,46,52,13,50,39,-3,0,-4,1,95,41,18,99,65,2,2,2,6
LEMONTREE,189,309,63,51,-7,67,63,2,2,2,1,4,101,39,20,105,65,1,2,8,5,51,51,14,55,39,-3,1,-1,1,90,46,14,94,69,-3,2,3,5
CYIENT,190,308,86,272,13,95,63,2,2,3,3,9,98,267,24,107,59,1,2,7,5,29,276,4,38,33,-3,-2,-3,0,86,272,16,95,69,-3,2,2,0
COROMANDEL,191,308,87,268,16,102,55,2,2,6,6,15,80,273,14,95,59,-2,2,3,4,63,271,16,78,49,-3,0,-2,3,63,277,6,78,53,-2,3,6,-3
SONACOMS,192,308,77,177,11,80,59,-3,1,5,4,3,85,181,10,88,59,2,2,6,6,65,178,16,68,35,2,2,6,4,78,179,7,81,65,1,2,2,1
FLUOROCHEM,193,308,50,112,18,60,15,2,2,8,5,10,84,111,13,94,66,-3,2,2,4,83,102,21,93,43,2,2,9,6,81,111,6,91,67,-2,3,6,1
JUBLPHARMA,194,307,93,295,16,139,63,2,2,4,6,46,57,299,9,103,31,2,2,7,6,31,303,-12,77,47,-3,0,-2,1,80,296,19,126,49,-2,2,8,4
ACI,195,307,46,52,7,56,23,2,3,6,5,10,88,45,15,98,65,-2,2,5,3,83,38,21,93,43,2,2,9,6,80,48,12,90,59,-2,2,5,4
BANKBARODA,196,306,70,464,3,74,63,2,2,-1,1,4,105,455,21,109,65,2,2,9,6,33,463,-7,37,41,-3,2,-4,4,94,460,18,98,65,2,2,3,4
GMDCLTD,197,304,57,334,14,66,29,2,2,5,5,9,94,325,21,103,59,2,2,4,6,61,331,18,70,39,-3,2,0,5,83,332,11,92,68,-3,3,3,1
SOLARINDS,198,304,64,101,16,132,55,-3,0,-2,-2,68,110,99,26,178,65,2,2,9,6,-35,112,-10,33,-11,-3,-2,-6,-3,97,99,24,165,66,-3,2,4,4
IOC,199,303,73,465,5,73,63,2,2,-1,2,0,107,456,23,107,65,2,2,9,6,26,465,-5,26,41,-3,0,-4,-3,97,461,24,97,66,-3,2,4,4
BOSCHLTD,200,302,59,483,14,132,50,-3,0,-2,0,73,105,483,21,178,65,2,2,9,6,-39,488,-13,34,-19,-3,4,-4,-4,104,483,24,177,65,2,2,6,5
BPCL,201,301,45,149,-6,47,47,-2,3,1,2,2,102,140,18,104,65,2,2,9,6,55,146,-3,57,49,2,2,1,4,97,142,21,99,65,1,2,4,4
"L&TFH",202,299,87,43,11,91,63,2,2,3,6,4,92,46,16,96,59,2,2,7,6,25,55,-10,29,41,-3,0,-4,1,91,43,18,95,69,-3,2,2,3
SANOFI,203,295,54,79,14,52,29,2,2,2,5,-2,94,78,19,92,59,2,2,6,6,58,76,15,56,47,-3,2,-3,0,91,76,15,89,70,-2,3,2,3
EQUITASBNK,204,294,56,428,11,66,29,2,2,7,5,10,87,429,20,97,59,-3,2,4,5,62,428,16,72,41,-2,2,0,5,79,430,13,89,68,-3,1,2,-2
DIVISLAB,205,294,87,301,17,97,55,2,2,6,5,10,62,315,3,72,52,-3,2,4,4,67,302,16,77,55,-3,2,-1,-2,68,308,5,78,53,-2,3,6,3
NCC,206,293,84,143,13,85,62,2,2,0,5,1,104,139,21,105,65,2,2,9,5,7,150,-8,8,25,-3,-2,-3,-2,97,144,18,98,66,2,2,4,5
SUZLON,207,292,57,430,7,61,37,2,2,4,5,4,82,434,26,86,38,2,2,8,6,57,431,8,61,49,-2,2,-4,4,92,428,20,96,70,-3,3,2,0
GSFC,208,292,57,335,16,65,29,2,2,3,5,8,85,331,19,93,59,-3,2,3,5,59,333,16,67,47,-3,0,-4,3,83,333,15,91,67,-3,3,1,0
FINPIPE,209,291,89,486,18,99,61,2,2,0,6,10,101,485,19,111,65,2,2,8,5,-7,492,-12,3,15,-3,-2,-5,0,98,486,15,108,69,2,2,6,4
TCS,210,290,48,468,-6,53,41,2,3,5,3,5,94,461,18,99,65,2,2,6,1,58,458,10,63,35,2,2,6,3,85,463,14,90,66,-3,2,2,4
WELSPUNLIV,211,289,75,304,4,76,61,2,2,1,5,1,92,306,16,93,60,2,2,6,6,34,308,18,35,25,-3,-2,-5,1,87,305,14,88,69,-3,3,1,3
ENGINERSIN,212,288,88,330,15,89,61,2,2,2,6,1,101,326,19,102,64,2,2,8,6,4,339,-8,5,25,-3,-2,-5,-3,94,329,19,95,70,-3,2,2,4
JSWSTEEL,213,288,80,107,9,92,63,2,2,3,1,12,91,107,18,103,66,-3,2,7,1,20,113,-7,32,39,-3,-2,-5,-2,85,106,7,97,69,-2,2,6,3
PIIND,214,287,78,460,14,84,59,-3,2,0,6,6,91,462,16,97,66,-3,2,7,3,15,467,13,21,15,-3,-2,-5,-3,97,456,12,103,69,2,2,7,5
SHRIRAMFIN,215,287,86,398,16,87,61,2,2,-1,6,1,101,401,19,102,64,2,2,9,5,-1,405,-15,0,25,-3,-2,-6,0,100,397,21,101,69,-2,2,4,6
"J&KBANK",216,287,65,363,-7,69,63,2,2,2,3,4,102,359,24,106,59,2,2,9,6,28,366,-4,32,41,-3,0,-4,-2,88,363,18,92,66,-3,2,3,2
ADANIENT,217,286,60,466,-8,60,61,2,2,-1,4,0,90,464,16,90,66,-3,2,4,5,42,460,-4,42,49,-3,0,-4,4,94,462,16,94,65,2,2,6,3
MMTC,218,286,81,14,13,85,57,2,2,2,5,4,50,24,21,54,13,2,2,6,6,53,17,14,57,47,-3,0,-3,-2,98,13,21,102,70,-3,2,2,6
IOB,219,285,77,463,8,78,61,2,2,-1,5,1,89,465,26,90,45,2,2,8,6,19,468,16,20,15,-3,-2,-5,-2,99,457,24,100,65,-2,2,4,6
LAURUSLABS,220,285,93,104,17,105,63,2,2,4,5,12,69,118,8,81,52,-3,3,5,4,17,114,-13,29,39,-3,0,-4,-2,94,103,10,106,69,2,2,7,4
SAREGAMA,221,284,85,44,13,87,63,2,2,2,3,2,84,53,14,86,66,-3,2,1,4,42,53,14,44,39,-3,0,-4,-4,71,50,3,73,59,-2,2,4,5
INDIANB,222,283,80,461,8,80,61,2,2,2,5,0,107,457,24,107,65,2,2,9,5,7,471,-8,7,25,-3,-2,-5,0,89,465,18,89,65,-3,2,3,4
SUPREMEIND,223,283,72,277,13,72,53,1,2,-1,4,0,90,276,20,90,59,1,2,2,6,38,275,-10,38,45,-2,3,5,-3,83,276,14,83,70,-3,2,-1,1
UCOBANK,224,282,73,276,4,74,61,2,2,-1,5,1,87,278,26,88,44,2,2,8,5,26,278,14,27,25,-3,-2,-5,-3,95,271,21,96,66,-2,2,3,5
COLPAL,225,282,42,233,-4,117,47,-3,0,-1,3,75,101,229,23,176,59,2,2,9,6,-29,245,-11,46,-19,2,3,-1,-3,93,229,23,168,65,-3,2,2,4
BANKINDIA,226,281,78,48,3,82,63,2,2,3,5,4,83,51,21,87,44,2,2,8,6,26,54,12,30,25,-3,-2,-4,-2,90,45,18,94,65,-2,2,3,4
RVNL,227,280,62,404,-7,60,61,1,2,1,4,-2,97,405,26,95,58,2,2,4,5,30,403,-5,28,31,-3,4,2,1,93,403,21,91,66,-3,2,3,4
JSL,228,280,34,12,-9,105,50,-3,0,-2,-2,71,110,6,26,181,65,2,2,9,6,-21,19,-15,50,9,-3,-2,-5,-5,86,7,16,157,66,-3,2,2,3
BIRLACORPN,229,279,43,246,10,47,23,2,2,4,2,4,94,240,19,98,59,2,2,6,6,49,242,13,53,39,-2,2,-1,-2,89,240,18,93,65,-3,3,2,4
CELLO,230,279,53,111,8,62,29,2,2,7,5,9,56,123,-11,65,65,-2,2,0,2,87,101,13,96,63,-3,2,6,6,74,114,8,83,57,-2,1,6,4
CHAMBLFERT,231,278,90,238,15,93,63,2,2,3,5,3,85,248,10,88,65,-3,2,7,4,20,250,-12,23,39,-3,0,-5,1,80,246,9,83,69,-2,2,3,-1
MANKIND,232,277,81,396,11,99,61,2,2,-1,6,18,88,397,20,106,65,-2,2,1,2,0,404,-12,18,25,-3,-2,-5,-3,90,393,14,108,59,2,2,8,5
OIL,233,277,74,205,16,71,56,-2,2,-2,4,-3,109,202,26,106,64,2,2,9,6,-5,211,-7,-8,15,-3,-2,-5,-3,102,204,24,99,65,2,2,4,5
SPARC,234,276,76,274,12,88,57,2,2,-1,4,12,100,266,17,112,65,2,2,8,6,-11,281,-20,1,15,-3,1,-5,1,99,267,19,111,69,2,2,3,4
IRFC,235,274,63,431,-6,60,61,2,2,2,2,-3,103,427,28,100,58,2,2,8,5,18,436,16,15,15,-3,-2,-5,-3,93,429,21,90,65,-3,2,4,4
IDBI,236,274,81,332,10,82,61,2,2,2,4,1,83,338,21,84,45,2,2,8,5,18,338,-12,19,39,-3,0,-3,-3,91,331,18,92,65,-2,2,3,5
BAJFINANCE,237,273,76,302,16,82,43,2,2,7,6,6,69,313,9,75,59,-3,2,2,0,71,301,11,77,59,2,2,-1,-2,51,314,6,57,37,2,3,5,-2
FINCABLES,238,273,68,206,19,68,35,2,2,5,5,0,83,212,18,83,59,-3,2,3,4,60,207,-4,60,59,-2,0,4,3,62,211,12,62,44,-3,1,5,3
BAYERCROP,239,273,33,116,13,34,5,2,2,5,6,1,84,115,11,85,59,2,2,5,5,69,108,13,70,41,2,2,6,5,86,112,13,87,67,-3,3,1,5
RELIANCE,240,271,66,306,10,66,57,-2,2,-1,0,0,97,304,16,97,65,2,2,8,4,12,310,-6,12,29,-3,0,-5,-3,96,302,19,96,65,2,2,3,5
HINDPETRO,241,271,45,310,4,47,33,2,3,2,1,2,101,300,19,103,65,2,2,8,5,34,307,15,36,9,2,2,2,4,89,304,20,91,64,-3,2,3,3
KPRMILL,242,271,80,204,16,86,61,-3,2,2,2,6,87,207,20,93,59,-3,2,4,5,3,210,-12,9,9,2,3,0,1,95,203,18,101,70,-3,2,5,3
WESTLIFE,243,271,48,113,16,58,15,2,2,7,6,10,82,112,16,92,60,-3,2,2,5,95,100,16,105,63,2,2,7,5,36,123,-10,46,37,-2,3,5,3
OBEROIRLTY,244,271,78,49,13,81,59,1,2,-1,4,3,102,40,21,105,65,1,2,8,5,-6,57,-9,-3,15,-3,-2,-4,-3,94,42,18,97,69,-2,2,3,4
IGL,245,268,93,357,16,112,63,2,2,4,6,19,82,361,3,101,66,2,2,6,3,29,363,-10,48,47,-3,0,-2,-3,45,370,6,64,25,2,2,6,4
INDUSINDBK,246,268,83,17,6,83,63,2,2,5,5,0,84,20,14,84,59,-3,2,7,5,34,23,-7,34,47,-3,0,-3,0,67,21,-5,67,70,-3,2,2,1
OFSS,247,266,31,300,-10,99,48,-3,0,-2,-2,68,105,292,21,173,65,2,2,9,6,-41,309,-14,27,-19,-3,1,-1,-5,103,293,26,171,65,2,2,2,6
SAFARI,248,265,58,364,15,62,29,2,2,5,5,4,91,364,23,95,60,-3,2,4,5,68,360,21,72,49,-3,2,-4,3,44,372,-10,48,54,-3,1,1,1
CUB,249,265,99,265,19,114,63,2,2,7,6,15,29,284,3,44,17,-2,3,5,3,73,266,20,88,55,-3,0,-2,3,49,279,6,64,31,2,2,7,1
MAHABANK,250,264,82,359,13,83,62,2,2,-1,4,1,86,366,23,87,45,2,2,9,5,-1,369,-6,0,15,-3,-2,-5,0,96,358,21,97,66,-2,2,4,5
CARBORUNIV,251,263,80,488,16,87,55,2,2,0,5,7,89,490,16,96,66,-3,2,4,4,-11,493,-10,-4,9,-3,-2,-6,1,98,487,15,105,69,2,2,6,4
GMRINFRA,252,263,68,243,-3,69,61,2,2,1,5,1,101,237,24,102,59,2,2,8,6,2,251,-10,3,25,-3,-2,-5,-3,91,241,20,92,66,-3,2,3,3
ZYDUSLIFE,253,260,32,485,-10,100,48,-3,0,-4,1,68,105,484,23,173,64,2,2,9,5,-46,490,-11,22,-19,-3,-2,-6,-5,101,484,24,169,65,2,2,3,5
BHARATFORG,254,260,45,369,3,49,29,2,2,4,5,4,85,365,16,89,60,-3,2,7,3,38,364,7,42,29,2,2,-2,0,88,360,16,92,68,-3,3,1,3
AIAENG,255,259,77,275,13,74,57,2,2,-2,5,-3,99,271,24,96,59,2,2,7,5,-7,282,-12,-10,15,-3,-2,-4,-1,93,274,21,90,70,-2,2,2,0
APLLTD,256,258,58,493,10,55,43,2,2,-4,5,-3,98,491,15,95,65,2,2,8,6,12,491,-7,9,21,-2,1,-1,0,93,490,21,90,65,-2,2,1,6
TANLA,257,257,43,22,17,52,9,2,2,7,6,9,78,16,13,87,60,-3,2,1,5,70,13,19,79,41,2,2,1,5,57,22,12,66,37,-2,1,5,4
SHYAMMETL,258,254,44,151,4,37,29,2,2,2,5,-7,94,150,19,87,59,2,2,7,5,40,147,15,33,27,-3,0,-3,4,83,149,13,76,63,-3,3,2,5
MINDACORP,259,252,74,491,13,71,57,2,2,-2,2,-3,102,488,24,99,59,2,2,9,6,-6,494,-7,-9,15,-3,-2,-4,-5,85,493,16,82,65,-3,2,0,5
ADANIGREEN,260,252,61,21,4,58,57,-3,2,-2,3,-3,90,15,15,87,65,-3,2,6,5,12,25,9,9,15,-3,-2,-3,-4,92,16,18,89,65,-3,2,4,6
NH,261,250,65,210,8,56,57,2,2,-2,-2,-9,100,208,24,91,59,2,2,7,6,0,212,-3,-9,15,-3,-2,-5,-2,94,208,20,85,69,-3,2,2,4
NATCOPHARM,262,250,63,145,13,61,49,-3,0,-1,5,-2,92,148,17,90,59,2,2,7,5,4,151,16,2,-13,-2,4,3,-4,93,146,16,91,65,2,2,3,5
IRCON,263,248,57,467,-7,54,57,2,2,-2,5,-3,103,460,26,100,59,2,2,9,5,-1,472,-3,-4,15,-3,-2,-6,-2,92,464,20,89,66,-3,2,3,4
BIKAJI,264,248,58,146,18,59,29,2,2,3,4,1,87,149,13,88,65,-2,2,3,6,28,148,-13,29,41,-3,2,-4,5,74,150,13,75,58,-3,3,3,0
PNBHOUSING,265,246,70,109,19,79,35,2,2,6,6,9,35,125,15,44,6,2,2,6,4,62,106,18,71,49,-3,0,-2,0,70,116,13,79,54,-3,1,2,3
GNFC,266,245,69,462,18,78,35,2,2,6,6,9,69,469,6,78,60,-3,2,2,2,30,461,-10,39,49,-3,0,-4,-2,68,466,12,77,53,-3,0,6,0
JKCEMENT,267,244,66,207,-5,67,61,2,2,1,5,1,99,205,18,100,66,1,2,7,5,-12,213,-13,-11,15,-3,-2,-4,-5,90,207,19,91,65,-3,2,3,4
CHOLAFIN,268,243,81,458,16,87,53,2,2,2,6,6,86,463,21,92,59,-3,2,4,3,3,469,-10,9,25,-3,-2,-4,-3,67,468,12,73,54,-2,3,4,-4
ITC,269,243,40,54,15,40,15,2,2,5,1,0,86,52,23,86,60,-3,2,1,3,75,44,16,75,61,-3,2,-1,0,42,54,10,42,29,-2,4,0,1
SBILIFE,270,241,62,366,6,60,61,-3,2,-1,-3,-2,84,368,14,82,59,-3,2,7,5,15,367,-5,13,29,-3,0,-3,-3,82,366,14,80,66,-3,2,0,3
AMBER,271,241,60,429,-5,62,55,2,2,1,5,2,92,431,19,94,59,2,2,6,4,1,437,-3,3,15,-3,1,-5,-4,86,432,15,88,69,-3,2,2,1
RCF,272,241,56,20,14,60,29,2,2,3,6,4,84,13,18,88,59,-3,2,2,6,39,22,16,43,27,-3,0,-4,3,58,23,-10,62,68,-3,1,1,1
SKFINDIA,273,240,40,245,16,50,9,2,2,8,3,10,76,249,16,86,60,-3,0,2,1,82,234,17,92,61,2,2,0,0,32,250,4,42,17,2,4,5,0
LT,274,239,59,209,13,59,49,-3,2,-2,0,0,104,203,26,104,59,2,2,9,6,-16,214,-9,-16,9,-3,-2,-6,-5,92,206,20,92,69,-3,2,3,1
UJJIVANSFB,275,237,59,179,18,60,29,2,2,3,5,1,73,188,18,74,39,2,2,6,6,33,181,-10,34,47,-3,3,-3,-1,71,181,15,72,54,-3,1,1,3
POWERGRID,276,235,55,147,10,52,41,2,2,-4,4,-3,106,143,21,103,66,2,2,9,6,-13,152,-13,-16,15,-3,-2,-5,-5,90,148,20,87,65,-3,2,2,4
HAVELLS,277,234,69,110,13,66,55,-3,0,-1,5,-3,91,114,15,88,65,-3,2,7,5,-20,117,-10,-23,-1,-3,1,-4,-3,97,109,18,94,65,2,2,5,5
DCMSHRIRAM,278,233,35,433,13,42,9,2,2,5,4,7,80,433,16,87,59,-3,2,1,5,59,429,20,66,35,-3,2,-1,6,52,437,13,59,37,-3,1,4,0
AUROPHARMA,279,233,70,403,13,64,55,2,2,-2,0,-6,94,406,19,88,59,2,2,7,5,-13,407,-14,-19,15,-3,-2,-7,-2,88,405,18,82,69,-3,2,2,0
JWL,280,233,71,77,7,65,57,2,2,-2,5,-6,94,81,24,88,59,1,2,4,4,-16,81,-12,-22,9,-3,-2,-6,-2,90,77,16,84,70,-3,2,2,3
LICI,281,232,80,333,13,81,61,2,2,1,1,1,62,344,14,63,36,-2,2,6,6,-3,343,-8,-2,15,-3,1,-4,-4,92,330,21,93,65,-3,2,3,4
RBLBANK,282,231,59,365,15,62,29,2,2,6,5,3,13,378,14,16,-15,2,2,5,5,69,359,16,72,55,-3,0,-2,3,87,364,14,90,68,-3,3,1,4
CREDITACC,283,231,47,53,15,52,19,2,2,4,5,5,84,48,16,89,59,2,2,1,4,72,42,17,77,43,2,2,5,3,23,58,-10,28,36,-3,1,-1,0
CRAFTSMAN,284,230,45,78,16,54,15,2,2,5,5,9,76,82,16,85,57,-3,2,1,3,74,72,9,83,61,2,2,2,-2,26,88,-11,35,39,-3,1,0,0
CANFINHOME,285,228,80,360,16,81,57,2,2,-2,5,1,82,367,17,83,59,-3,2,6,1,-10,370,-15,-9,15,-3,-2,-4,-1,75,367,6,76,68,-2,2,1,0
ELECON,286,228,66,307,7,63,49,2,2,1,5,-3,90,311,24,87,59,-3,2,4,4,-13,312,-14,-16,15,-3,-2,-4,-5,88,307,14,85,69,-3,3,1,4
AXISBANK,287,227,39,247,4,42,29,2,2,2,0,3,81,250,14,84,59,-3,2,6,3,23,249,14,26,19,-3,0,-4,-3,81,244,11,84,68,-3,3,1,1
KFINTECH,288,226,66,76,10,68,51,2,2,-4,5,2,91,77,19,93,65,-2,2,4,3,-5,80,-7,-3,15,-3,-2,-5,-3,72,80,18,74,53,-3,2,0,2
ICICIGI,289,225,39,340,-5,36,49,-3,2,-4,0,-3,97,330,15,94,65,2,2,8,5,-7,344,-10,-10,15,-3,-2,-5,-2,99,327,23,96,65,2,2,2,5
PRESTIGE,290,223,52,368,9,49,41,2,2,-2,0,-3,101,362,24,98,59,2,2,9,5,-14,372,-11,-17,9,-3,-2,-6,-1,87,365,18,84,70,-3,2,0,0
AMBUJACEM,291,220,48,248,-3,42,49,-3,2,-2,5,-6,102,243,19,96,65,2,2,8,6,-18,252,-16,-24,15,-3,-2,-7,-5,94,243,18,88,65,2,2,2,5
DELHIVERY,292,219,81,15,5,84,63,2,2,6,3,3,-23,30,8,-20,-38,-2,3,2,4,86,10,16,89,63,2,2,3,0,72,18,13,75,45,2,2,5,5
ONGC,293,218,35,371,-6,32,41,2,2,-4,0,-3,105,360,21,102,65,2,2,9,6,-14,371,-11,-17,9,-3,-2,-4,-3,95,362,24,92,65,-3,2,2,5
SIGNATURE,294,218,45,338,-10,42,50,2,2,-3,4,-3,89,336,22,86,64,-2,2,1,2,2,342,-13,-1,29,-3,-2,-4,-5,85,336,24,82,55,-2,2,2,4
TEJASNET,295,218,43,309,16,49,15,2,2,3,5,6,83,309,18,89,59,-3,2,2,5,31,306,-12,37,47,-3,0,-2,1,55,313,11,61,37,-2,4,5,0
KOTAKBANK,296,218,58,242,10,69,35,2,2,6,3,11,56,251,6,67,50,-3,1,1,1,82,233,16,93,61,2,2,0,1,11,251,-7,22,11,2,3,5,-3
APOLLOTYRE,297,216,-4,250,-13,-1,-3,2,3,4,3,3,92,245,21,95,59,1,2,4,5,49,244,16,52,19,2,2,6,4,76,247,16,79,59,-3,0,1,3
MRPL,298,215,47,311,4,44,50,-3,0,-4,0,-3,110,298,26,107,65,2,2,9,6,-36,314,-13,-39,-11,-3,-2,-5,-2,97,303,24,94,65,-2,2,2,6
SUNTV,299,214,42,148,10,48,19,2,2,4,5,6,84,147,13,90,59,1,2,3,6,57,143,16,63,35,1,2,-2,5,25,154,-13,31,44,-3,1,-1,-3
ASTRAZEN,300,213,18,280,11,17,-3,2,3,2,3,-1,91,277,21,90,59,2,2,1,6,27,279,20,26,7,-3,0,-2,5,78,278,15,77,61,-3,3,1,1
POLYMED,301,210,48,181,-6,47,51,2,2,-1,0,-1,91,179,19,90,59,-2,2,7,6,-9,182,-9,-10,9,-2,-2,-3,-2,81,180,16,80,63,-3,2,0,3
LATENTVIEW,302,205,93,326,16,102,63,2,2,4,6,9,7,349,11,16,-14,-2,2,5,5,15,336,-12,24,39,-3,-2,-5,-2,81,334,19,90,49,-2,2,7,6
BIOCON,303,204,86,457,8,90,63,2,2,5,6,4,5,479,-6,9,-1,2,3,2,5,67,457,18,71,49,-3,0,-1,4,42,472,17,46,17,-2,2,4,4
CGPOWER,304,203,55,367,14,59,47,-3,0,-4,1,4,92,363,24,96,60,-3,2,4,5,-36,375,-10,-32,-19,2,1,-7,-3,88,361,16,92,65,2,2,0,3
SUMICHEM,305,202,50,208,19,64,15,2,2,8,4,14,34,219,-7,48,44,-3,1,1,-2,93,196,24,107,63,-3,2,2,5,11,217,5,25,-1,2,3,5,-3
PFC,306,201,39,150,-3,43,37,2,2,0,1,4,102,137,26,106,59,2,2,8,5,-31,153,-9,-27,-9,-3,-2,-5,-3,87,147,23,91,64,-3,2,0,1
APLAPOLLO,307,198,50,336,-3,51,55,-3,2,-1,0,1,86,335,21,87,59,-3,2,3,4,0,341,-3,1,15,-3,-2,-4,-3,61,342,4,62,55,-3,3,4,-2
CHENNPETRO,308,194,39,117,-3,33,41,1,0,-4,4,-6,104,110,26,98,59,2,2,9,6,-32,121,-8,-38,-11,-3,-2,-6,-2,89,115,20,83,63,-3,2,2,5
TATACOMM,309,193,35,81,-5,42,41,-3,0,-2,4,7,96,74,21,103,60,2,2,7,4,-35,82,-16,-28,-11,-3,1,-1,-5,90,74,16,97,65,2,2,0,5
PRSMJOHNSN,310,187,60,180,16,55,41,1,0,-4,6,-5,94,180,18,89,59,2,2,7,6,-51,186,-15,-56,-25,-3,1,-8,-1,89,178,18,84,67,-3,2,0,5
ROUTE,311,181,36,341,-10,31,49,2,2,-2,-5,-5,79,340,11,74,59,-3,2,6,4,-12,345,-16,-17,1,-2,1,3,1,83,338,16,78,69,-3,2,1,-2
FIVESTAR,312,179,70,492,14,68,53,2,2,2,-3,-2,88,494,18,86,65,-2,2,4,1,-12,496,-15,-14,9,-3,1,-3,-1,35,497,-8,33,43,-2,3,1,-2
UNIONBANK,313,177,49,432,11,43,41,-3,0,-4,4,-6,87,436,24,81,44,2,2,9,6,-42,442,-10,-48,-19,-3,-2,-5,-3,89,433,20,83,64,-2,2,1,4
SWANENERGY,314,177,42,115,-3,41,43,2,2,-4,2,-1,103,108,21,102,65,2,2,7,6,-23,118,-9,-24,-9,-3,-2,-4,4,56,120,-12,55,63,-3,2,1,5
OLECTRA,315,177,53,80,10,47,43,2,0,-4,2,-6,95,79,23,89,59,-3,2,8,6,-55,88,-8,-61,-35,-3,-2,-5,-2,90,78,21,84,64,-3,2,1,5
SUNDRMFAST,316,174,14,23,14,26,-15,2,2,6,5,12,72,19,18,84,54,-3,0,0,3,76,12,21,88,55,-3,2,0,1,0,27,-13,12,13,-2,1,3,-2
BALKRISIND,317,171,12,344,13,18,-9,2,2,3,1,6,77,339,14,83,59,-3,2,1,4,33,335,-5,39,47,-3,0,-4,-2,43,345,8,49,33,-2,4,0,0
ISEC,318,168,-1,441,4,-4,-11,2,4,2,-2,-3,88,435,16,85,59,2,2,4,5,18,435,13,15,-9,2,2,6,4,66,435,21,63,51,-3,0,-1,-2
TIMKEN,319,167,11,214,13,23,-15,2,2,5,4,12,69,213,18,81,52,-3,0,-1,3,85,199,10,97,61,2,2,6,4,-10,221,-10,2,-7,-2,4,2,3
PPLPHARMA,320,166,95,39,19,103,63,2,2,3,6,8,-43,61,-13,-35,-37,-2,3,1,5,69,43,23,77,47,-3,0,-2,4,37,53,6,45,25,-3,2,6,1
CRISIL,321,161,30,313,16,24,25,-3,-2,-3,-3,-6,104,303,21,98,66,2,2,7,6,-60,317,-7,-66,-43,2,-2,-6,-4,93,306,20,87,63,2,2,1,5
IEX,322,159,66,361,14,75,35,2,2,8,5,9,-35,380,4,-26,-41,-3,3,4,-2,93,356,21,102,63,2,2,1,4,26,375,5,35,15,-3,2,6,1
TRIDENT,323,159,26,212,10,24,9,2,2,2,1,-2,79,214,13,77,60,-3,2,2,5,-17,215,13,-19,-19,-3,-2,-4,-2,73,210,13,71,55,-3,3,1,4
TORNTPHARM,324,157,17,435,-6,17,25,-2,-2,-3,5,0,98,428,21,98,60,2,2,9,4,-47,441,-5,-47,-43,2,1,-3,1,89,431,20,89,63,-3,2,2,5
HBLPOWER,325,157,21,183,-10,18,27,2,2,-4,4,-3,100,177,26,97,59,2,2,5,6,-36,185,-12,-39,-9,-3,-2,-5,-5,75,183,16,72,59,-3,0,0,3
ABFRL,326,152,47,337,19,48,15,2,2,3,6,1,60,345,4,61,49,-3,4,2,4,19,337,-10,20,39,-3,0,-5,-2,25,346,11,26,9,-2,0,4,3
MAHSEAMLES,327,152,-3,184,4,1,-15,2,3,0,3,4,97,174,24,101,59,2,2,4,6,-28,183,7,-24,-29,-3,-2,-5,4,82,177,20,86,62,-3,3,0,0
RAILTEL,328,148,11,496,-7,12,13,1,3,-4,5,1,99,487,23,100,59,2,2,7,6,-50,498,-7,-49,-29,-3,-2,-6,-3,87,492,20,88,64,-3,2,0,4
JSWINFRA,329,145,29,24,-7,26,39,-3,0,-4,4,-3,83,21,18,80,65,-2,2,1,-1,-35,27,-8,-38,-19,-3,4,-6,-3,71,20,13,68,53,-2,2,1,4
VBL,330,142,25,409,-6,19,39,-3,0,-5,0,-6,104,403,26,98,59,2,2,9,6,-72,410,-13,-78,-43,-3,-2,-6,-5,91,404,24,85,64,-3,2,1,3
SUNPHARMA,331,142,23,281,-9,13,39,-3,0,-4,0,-10,104,274,23,94,65,2,2,7,5,-71,287,-14,-81,-43,-3,-2,-6,-3,96,275,23,86,63,2,2,1,5
AUBANK,332,140,21,470,18,31,-15,2,2,8,6,10,50,474,9,60,45,-3,0,1,-2,81,453,17,91,61,-2,2,3,0,-22,477,-13,-12,-14,-2,4,3,0
AJANTPHARM,333,139,36,471,11,30,29,-3,0,-5,4,-6,94,466,18,88,59,2,2,7,6,-62,477,-13,-68,-43,1,1,-6,-2,77,469,18,71,59,-3,2,0,1
KNRCON,334,138,1,497,6,2,-15,2,2,2,4,1,71,496,11,72,57,-3,0,1,5,32,489,13,33,27,-3,0,-2,-3,33,496,-7,34,39,-3,1,-1,4
BALAMINES,335,138,13,215,13,17,-15,2,2,5,6,4,39,220,4,43,32,-3,4,-1,3,75,206,9,79,59,2,2,0,3,7,219,3,11,-1,-3,1,4,3
AAVAS,336,137,69,176,19,84,35,2,2,6,5,15,0,190,-6,15,0,-3,4,2,3,79,173,24,94,55,-3,0,-1,4,-26,190,10,-11,-44,2,3,6,-3
NESTLEIND,337,133,9,346,-3,12,15,-3,1,-1,0,3,87,333,18,90,59,2,2,1,5,-36,346,7,-33,-49,2,2,2,0,70,339,14,73,60,-3,2,-1,-2
PERSISTENT,338,133,3,251,-15,-3,13,2,4,-2,1,-6,94,247,24,88,59,-3,2,7,5,-36,254,-9,-42,-31,2,2,2,-2,78,249,21,72,59,-3,0,0,1
ECLERX,339,132,10,347,4,11,-1,2,2,-1,4,1,88,334,18,89,59,-3,2,7,5,-47,347,-5,-46,-29,-3,-2,-4,-4,80,337,16,81,61,-3,3,-1,4
NYKAA,340,131,98,38,17,116,63,2,2,8,6,18,-67,62,-15,-49,-55,-2,3,1,1,76,37,16,94,59,-3,2,1,1,6,59,9,24,-13,-2,2,7,3
TRIVENI,341,129,29,407,3,30,17,2,2,2,3,1,83,408,18,84,59,-3,2,2,5,-18,406,-10,-17,-5,-3,0,-3,3,34,412,4,35,29,-3,1,-1,4
GMMPFAUDLR,342,129,22,406,21,36,-15,2,2,7,5,14,33,413,14,47,24,-3,-2,-1,1,88,393,21,102,61,2,2,1,1,-28,414,-13,-14,-15,-2,4,3,-5
PCBL,343,129,9,185,-6,0,5,2,2,0,6,-9,97,182,21,88,59,2,2,7,6,-49,187,-8,-58,-29,-3,-2,-5,-2,81,182,13,72,64,-3,3,-1,5
HDFCAMC,344,129,9,122,-8,4,25,-3,-2,-3,0,-5,96,113,19,91,59,2,2,8,6,-61,124,-9,-66,-43,-2,-2,-6,1,90,113,23,85,63,-3,2,1,4
JKPAPER,345,128,-10,472,16,-9,-39,2,2,5,4,1,70,471,16,71,54,-3,0,-1,4,53,459,20,54,35,-3,2,-1,0,14,474,8,15,9,-3,1,-1,0
TITAGARH,346,128,16,217,4,13,5,2,2,1,2,-3,88,210,24,85,57,-3,2,2,6,-57,217,-12,-60,-29,-3,-2,-6,-5,84,209,18,81,62,-3,3,1,3
FINEORG,347,127,12,154,16,16,-15,2,2,5,2,4,60,156,13,64,52,-3,-2,-3,3,66,140,20,70,49,-3,2,-4,2,-15,157,3,-11,-15,-2,1,2,-4
WHIRLPOOL,348,126,74,329,21,92,35,2,2,8,6,18,-23,351,-8,-5,-13,-2,1,1,-2,78,325,16,96,61,-3,2,1,1,-21,349,18,-3,-46,2,3,6,-4
MHRIL,349,125,23,153,-9,20,33,2,0,-4,1,-3,89,154,21,86,59,-3,2,4,6,-52,156,-7,-55,-35,-3,1,-5,-3,68,152,11,65,54,-3,3,-1,4
GODREJCP,350,124,14,436,6,11,15,-2,1,-4,-2,-3,96,432,16,93,65,2,2,7,4,-60,444,-5,-63,-43,-3,-2,-4,-3,77,434,16,74,59,-3,2,0,3
LALPATHLAB,351,123,18,55,16,28,-15,2,2,7,6,10,18,58,-6,28,26,-3,3,-3,1,76,40,17,86,43,2,2,8,4,1,60,-12,11,9,-3,1,3,3
GRINDWELL,352,121,-1,282,8,3,-25,2,2,6,6,4,70,280,16,74,54,-3,0,-1,4,48,273,-4,52,41,-3,2,7,5,0,281,-6,4,9,-3,1,-1,0
PRINCEPIPE,353,120,16,373,18,25,-15,2,2,4,5,9,61,375,14,70,46,-3,0,-1,5,56,362,16,65,47,-3,0,-2,-2,-22,380,-8,-13,-15,-3,1,3,0
DEEPAKFERT,354,119,17,343,14,26,-9,2,2,3,5,9,44,346,13,53,38,-3,-2,-3,1,51,334,8,60,47,-3,0,-4,3,-2,348,6,7,-15,-2,4,2,3
CHEMPLASTS,355,119,66,19,13,75,35,2,2,8,6,9,-28,29,3,-19,-44,2,3,4,4,47,18,-12,56,59,-2,2,0,0,25,25,6,34,9,-2,3,6,3
ULTRACEMCO,356,118,26,374,4,14,25,2,0,-5,0,-12,90,371,17,78,60,1,2,5,5,-61,381,-9,-73,-35,-3,-2,-7,-5,75,371,18,63,60,-3,0,-1,1
ERIS,357,117,-4,375,3,-4,-15,2,4,2,0,0,78,372,14,78,57,1,2,0,4,5,368,3,5,-9,2,2,4,3,38,374,13,38,30,-3,-2,-3,3
HDFCBANK,358,116,37,469,16,49,9,2,2,4,4,12,62,470,11,74,54,-3,1,1,-2,-4,470,-15,8,25,-3,-2,-5,-4,9,473,8,21,-9,2,3,4,1
CHOLAHLDNG,359,116,21,118,-3,17,31,-3,0,-2,-2,-4,86,117,19,82,59,2,2,1,3,-62,125,-13,-66,-35,-3,1,-7,-5,75,117,14,71,60,-3,2,-1,3
BLS,360,113,-19,187,-11,-23,-15,2,3,-1,3,-4,90,183,24,86,59,-3,2,4,4,-28,184,10,-32,-29,-3,1,-5,-2,74,184,15,70,60,-3,0,-1,3
RATNAMANI,361,113,30,82,4,31,17,2,2,1,4,1,79,84,23,80,57,-3,2,0,0,-45,85,-12,-44,-19,-3,-2,-4,-5,48,86,17,49,34,-3,1,-1,0
RENUKA,362,112,0,249,13,1,-25,2,2,4,4,1,63,252,18,64,46,-3,0,-1,3,61,240,19,62,39,-3,2,-1,5,-13,252,5,-12,-19,-3,1,2,1
TVSMOTOR,363,111,0,252,-6,-6,15,-3,-2,-5,1,-6,103,241,26,97,59,2,2,8,6,-67,256,-11,-73,-43,-3,-2,-5,-3,81,248,23,75,59,-3,2,0,0
SUNTECK,364,105,39,370,11,34,17,2,2,2,5,-5,78,373,11,73,60,-3,2,4,4,-54,378,-15,-59,-29,-3,-2,-4,-1,47,373,4,42,43,-3,1,1,1
GESHIP,365,105,20,119,-4,10,29,-3,0,-5,3,-10,87,119,20,77,59,-3,2,5,4,-67,128,-9,-77,-43,-3,-2,-6,-4,75,118,18,65,59,-3,2,-2,1
RHIM,366,102,18,278,16,32,-15,2,2,7,6,14,36,283,-10,50,46,-3,0,-1,4,68,269,16,82,41,-2,2,8,3,-34,284,-13,-20,-18,-3,1,2,-3
INTELLECT,367,99,2,376,-8,-13,15,-3,-2,-4,4,-15,95,370,19,80,59,2,2,7,6,-66,383,-16,-81,-43,-3,1,-5,0,83,369,20,68,60,-3,2,-1,5
ANGELONE,368,95,18,216,14,15,-1,2,2,0,1,-3,89,209,24,86,59,-3,2,1,6,-51,216,-9,-54,-35,-3,4,-5,-3,42,215,-11,39,56,-3,3,-1,-2
EASEMYTRIP,369,94,-25,91,-9,-34,-15,2,3,-4,-2,-9,91,83,21,82,66,-3,2,2,3,-24,84,14,-33,-29,-3,1,-4,-3,61,84,13,52,43,2,0,-1,4
TITAN,370,94,18,27,-4,8,29,-2,0,-5,0,-10,88,22,21,78,59,-3,2,4,5,-73,30,-14,-83,-43,-3,-2,-6,-5,71,24,14,61,59,-3,2,-2,1
JMFINANCIL,371,92,-29,189,-13,-28,-28,2,3,2,5,1,74,187,14,75,53,2,2,-1,4,39,180,19,40,17,-3,2,0,4,7,189,-13,8,24,-3,1,-2,0
NAVINFLUOR,372,91,17,312,14,32,-15,2,2,8,6,15,10,318,-13,25,31,-3,1,-4,-2,98,295,17,113,63,2,2,8,6,-49,319,-15,-34,-39,2,4,2,-3
JBMA,373,91,-23,124,-8,-38,-9,-2,4,-5,-3,-15,99,116,26,84,59,2,2,4,6,-47,123,3,-62,-55,2,3,0,0,77,119,21,62,60,-3,0,-2,1
FACT,374,89,-13,316,-6,-18,-15,2,3,-1,4,-5,90,312,21,85,59,1,2,1,6,-51,315,-10,-56,-29,-3,-2,-5,-2,68,311,13,63,56,-3,1,-3,4
MARICO,375,88,7,437,10,8,-15,2,2,4,4,1,38,442,-4,39,46,-3,0,-1,0,61,430,16,62,41,-3,2,0,5,-19,443,3,-18,-19,-3,1,2,-3
DEVYANI,376,87,11,495,11,23,-15,2,2,6,5,12,24,499,-8,36,38,-3,0,-1,-2,62,485,18,74,37,2,2,-1,4,-22,498,-12,-10,-14,-2,4,2,0
HEROMOTOCO,377,87,-5,186,-7,-20,15,-3,-2,-5,-3,-15,95,185,19,80,59,2,2,7,6,-67,190,-10,-82,-43,-3,-2,-7,-2,79,186,21,64,59,-3,2,-1,1
GILLETTE,378,86,5,410,-3,-5,15,-2,-2,-3,0,-10,89,409,16,79,58,2,2,6,5,-70,411,-11,-80,-43,-3,-2,-6,-5,72,409,20,62,54,-3,0,-2,3
BAJAJHLDNG,379,86,-21,86,-10,-27,-9,-2,4,-4,0,-6,86,85,24,80,59,-3,2,1,3,-43,86,8,-49,-55,2,3,2,-3,70,82,16,64,59,-3,0,-2,0
ACC,380,86,-3,60,-12,-15,15,-3,-2,-5,4,-12,96,54,16,84,65,2,2,6,5,-75,63,-16,-87,-43,-3,-2,-6,-5,80,51,16,68,59,-2,2,0,5
CROMPTON,381,85,41,308,16,51,9,2,2,8,4,10,-8,319,-8,2,-4,-3,4,2,1,79,299,17,89,43,2,2,9,6,-37,318,3,-27,-45,-2,1,5,1
TMB,382,85,10,120,11,7,-11,2,2,1,5,-3,74,121,13,71,59,-2,2,-1,3,-4,115,-8,-7,15,-3,-2,-4,-2,8,124,-6,5,13,-3,4,2,-2
ABBOTINDIA,383,85,-6,28,-10,-6,9,-2,1,-4,0,0,90,12,21,90,60,1,2,3,3,-73,28,-9,-73,-63,1,-2,-5,5,74,19,18,74,59,-3,2,-2,0
CEATLTD,384,81,3,315,-6,-3,11,2,1,-5,0,-6,98,307,24,92,59,2,2,6,5,-89,320,-12,-95,-63,-3,-2,-5,-4,75,310,16,69,59,-3,0,-1,4
BBTC,385,78,-10,377,-4,-16,-9,2,1,-3,3,-6,88,369,13,82,59,2,2,6,6,-73,382,-8,-79,-61,-3,1,-1,-1,79,368,18,73,59,-3,0,0,5
CIPLA,386,78,-6,62,-10,-21,15,-3,-2,-4,-2,-15,94,55,19,79,59,2,2,7,5,-72,62,-16,-87,-43,-3,1,-6,-5,77,52,16,62,59,-3,2,-1,4
TATAELXSI,387,78,2,58,-4,-1,3,1,2,-4,4,-3,81,56,18,78,60,-3,2,0,4,-41,59,-12,-44,-15,-3,-2,-5,-4,39,57,10,36,33,-3,1,-3,1
AETHER,388,77,13,345,15,17,-15,2,2,5,4,4,28,348,14,32,19,-2,-2,-1,0,70,330,24,74,41,-3,2,2,4,-38,351,-7,-34,-39,2,4,2,0
INDIACEM,389,77,-1,314,13,3,-25,2,2,2,5,4,69,314,14,73,53,-3,2,-1,4,-2,311,13,2,-5,-3,0,-4,-3,7,315,-6,11,15,-3,1,-1,1
PRAJIND,390,76,35,211,13,25,23,-3,0,-2,4,-10,76,216,16,66,57,-3,2,0,4,-59,219,-10,-69,-35,-3,-2,-6,-3,34,218,-6,24,42,-3,3,-3,1
KPITTECH,391,74,-18,475,-10,-30,-15,2,2,-1,4,-12,92,468,24,80,60,-3,2,5,4,-55,476,-12,-67,-29,-3,-2,-6,-3,67,471,13,55,57,-3,3,-1,-2
ALOKINDS,392,74,-14,473,-8,-16,-7,2,3,-4,0,-2,73,472,19,71,39,2,2,5,6,-59,475,-11,-61,-35,-3,1,-6,-5,76,467,18,74,59,-3,0,-1,3
VARROC,393,72,26,408,-3,23,25,2,2,-4,4,-3,20,414,19,17,-14,2,2,6,5,-46,408,-16,-49,-15,-3,-2,-7,-3,75,407,14,72,61,-3,3,-1,1
RECLTD,394,70,-9,349,-8,-19,9,-3,-2,-5,0,-10,102,332,26,92,59,2,2,8,5,-94,352,-16,-104,-63,-3,-2,-6,-4,81,340,21,71,60,-3,2,0,1
ASTRAL,395,69,1,284,-7,-5,15,-3,-2,-3,1,-6,80,281,18,74,60,-3,2,3,0,-71,286,-12,-77,-43,-3,-2,-7,-4,65,280,6,59,60,-2,2,-1,0
BSOFT,396,69,-24,89,-11,-33,-9,2,-2,-4,0,-9,97,80,21,88,59,2,2,7,6,-72,93,-9,-81,-63,2,1,-6,3,77,81,20,68,60,-3,0,-1,1
HDFCLIFE,397,66,31,372,-3,30,41,-3,0,-4,0,-1,72,374,9,71,59,-2,2,1,3,-68,379,-12,-69,-43,-3,1,-7,-4,32,376,8,31,25,-2,3,-3,1
RKFORGE,398,64,-16,157,-8,-16,-15,2,1,0,4,0,87,151,23,87,59,-3,2,2,4,-52,154,-4,-52,-35,-2,-2,-6,-3,45,153,-10,45,55,-3,3,-3,3
HSCL,399,63,-26,350,-9,-35,-15,2,3,-5,-2,-9,93,337,21,84,58,2,2,4,6,-59,348,-10,-68,-35,-3,-2,-5,-4,64,344,16,55,52,-3,0,-1,0
CAPLIPOINT,400,62,-27,317,-10,-33,-17,2,1,-1,-2,-6,93,310,20,87,59,1,2,5,6,-67,318,3,-73,-63,2,-2,-4,-3,69,312,18,63,51,-3,0,-1,4
DRREDDY,401,62,-8,156,-7,-11,9,-3,-2,-5,0,-3,89,152,15,86,59,2,2,6,5,-90,160,-11,-93,-63,-3,-2,-6,-5,74,151,13,71,60,-3,2,-1,3
GRANULES,402,61,-3,411,-5,-13,9,-3,-2,-5,3,-10,89,410,15,79,59,2,2,6,5,-92,414,-14,-102,-63,-3,-2,-7,-3,77,408,16,67,59,-3,2,-1,4
ITI,403,58,-18,63,-10,-23,-15,2,3,-2,4,-5,92,50,19,87,59,2,2,4,6,-56,60,-8,-61,-35,-3,-2,-6,-2,45,55,-12,40,56,-3,3,-3,4
SONATSOFTW,404,57,-24,188,-10,-27,-9,1,1,-5,-2,-3,97,178,24,94,59,1,2,5,6,-83,191,-10,-86,-63,-3,1,-4,-4,70,185,16,67,54,-3,0,-1,4
PAGEIND,405,57,5,26,10,11,-15,2,2,2,4,6,32,26,10,38,30,-3,1,-3,-3,40,21,15,46,29,-3,0,-4,3,-26,28,-10,-20,-15,-2,1,2,-2
SBFC,406,56,25,434,5,35,9,2,2,6,1,10,-41,447,-10,-31,-29,-2,1,0,-1,77,424,17,87,43,2,2,7,6,-15,442,10,-5,-35,2,1,5,2
MASTEK,407,52,-26,190,-8,-32,-17,2,1,-1,-3,-6,83,186,18,77,60,-3,2,0,6,-63,188,-6,-69,-57,-3,1,-1,3,64,187,14,58,51,-3,0,-3,5
LXCHEM,408,51,17,279,16,23,-15,2,2,6,6,6,16,285,10,22,7,-3,-2,1,3,76,268,19,82,43,2,2,6,4,-64,286,-8,-58,-59,-3,1,2,3
HOMEFIRST,409,48,-1,218,-5,-6,5,1,2,-4,0,-5,72,215,10,67,59,-3,2,0,4,-63,218,-16,-68,-35,-3,1,-6,-4,45,214,13,40,33,-2,1,-3,3
JYOTHYLAB,410,47,-18,61,-8,-21,-15,2,3,-1,1,-3,94,47,24,91,59,2,2,2,5,-66,61,-8,-69,-55,-3,1,-2,1,40,56,-15,37,56,-3,3,-1,0
TIINDIA,411,42,-31,445,-8,-38,-11,-3,-2,-4,-3,-7,87,437,23,80,60,-3,2,1,4,-75,446,-10,-82,-63,2,1,-2,-3,68,436,16,61,54,-3,0,-2,3
HAPPSTMNDS,412,42,-1,439,13,3,-25,2,2,4,3,4,10,443,-7,14,24,-3,-2,-3,1,70,426,21,74,41,-3,2,6,3,-41,445,4,-37,-43,-3,1,2,-2
RTNINDIA,413,42,-25,90,-10,-34,-15,2,1,-5,2,-9,83,86,20,74,59,-3,2,0,5,-67,92,-15,-76,-45,-3,-2,-1,-1,60,85,14,51,51,-3,0,-3,1
ALKYLAMINE,414,42,18,25,18,16,-15,2,2,5,6,-2,5,28,-10,3,20,-3,-2,-4,4,51,20,16,49,35,-3,2,-2,3,-30,29,5,-32,-39,-2,1,2,3
MAPMYINDIA,415,41,0,155,-5,-6,5,2,2,-2,-2,-6,60,158,16,54,38,-2,2,2,4,-46,155,-15,-52,-15,-3,-2,-6,-5,33,155,-7,27,42,-3,1,-3,3
APTUS,416,38,7,121,8,5,-9,2,3,0,3,-2,2,127,10,0,-19,2,2,4,3,-20,116,4,-22,-27,-2,3,-4,6,51,121,14,49,36,-3,3,1,0
YESBANK,417,37,42,494,4,43,37,2,2,-4,1,1,-12,500,13,-11,-39,2,2,5,5,-29,497,-8,-28,-9,-3,-2,-5,-2,35,495,20,36,15,-3,0,-1,4
HCLTECH,418,37,-36,477,-13,-49,-11,-3,1,-7,-3,-13,96,467,21,83,60,2,2,7,4,-86,480,-10,-99,-63,-3,-2,-7,-1,76,470,18,63,59,-3,0,-1,3
ADANIENSOL,419,37,35,339,8,39,17,2,2,2,4,4,11,350,-8,15,18,-3,4,0,0,-3,340,-6,1,9,-2,1,-5,0,-10,350,15,-6,-30,-2,2,4,1
EMAMILTD,420,35,-2,438,10,5,-25,2,2,4,5,7,44,441,11,51,39,-3,0,-3,0,35,433,-5,42,41,-3,2,2,-2,-49,446,-10,-42,-35,-3,1,-1,-1
SWSOLAR,421,34,-4,348,-10,-18,11,2,-2,-5,0,-14,60,347,16,46,30,2,2,5,5,-85,350,-8,-99,-63,-3,-2,-7,-2,77,341,18,63,59,-3,0,-2,5
SUVENPHAR,422,33,-32,125,-7,-39,-19,-3,-2,-4,3,-7,80,120,18,73,58,-3,2,0,5,-64,126,-10,-71,-61,2,4,1,0,56,122,14,49,44,-3,0,-3,4
SBICARD,423,32,15,342,18,26,-15,2,2,6,2,11,-20,352,-7,-9,-7,-3,1,-1,-3,81,326,24,92,55,-3,0,1,4,-55,352,-11,-44,-53,2,4,3,0
PVRINOX,424,30,14,213,13,23,-15,2,2,7,5,9,-6,223,-4,3,7,-3,-2,-4,0,72,205,16,81,41,2,2,7,4,-59,223,-15,-50,-43,-3,4,2,-4
MRF,425,28,-34,413,-16,-46,-11,-2,1,-6,0,-12,96,407,21,84,60,2,2,5,6,-91,415,-16,-103,-63,-3,-2,-5,-2,69,410,23,57,53,-3,0,-2,-2
GLAXO,426,27,-32,498,-11,-44,-17,2,1,-4,-3,-12,89,495,17,77,59,2,2,3,6,-76,501,3,-88,-63,-3,-2,-7,-4,58,494,13,46,51,-3,0,-4,1
GAEL,427,27,-17,412,-6,-20,-17,2,1,-1,4,-3,79,411,18,76,57,-3,2,0,5,-87,412,-10,-90,-63,-3,-2,-6,-3,55,411,13,52,44,-3,0,-3,4
MTARTECH,428,22,2,440,18,3,-27,2,2,2,5,1,59,439,13,60,46,-3,0,-1,4,-17,439,16,-16,-19,-3,-2,-6,-3,-23,444,-10,-22,-10,-3,1,1,-2
SYRMA,429,20,-38,286,-11,-39,-36,2,4,2,1,-1,81,279,18,80,59,-2,2,0,4,-14,283,4,-15,-31,2,3,5,3,-8,282,-12,-9,14,-3,1,-4,-4
STLTECH,430,20,17,182,17,23,-15,2,2,5,6,6,-25,191,-9,-19,-15,-3,1,-2,3,66,177,19,72,49,-3,0,-2,3,-44,191,3,-38,-53,-2,1,3,4
WIPRO,431,12,-40,351,-15,-55,-11,-3,-2,-6,-3,-15,83,341,12,68,60,2,2,2,5,-87,351,-9,-102,-63,-3,-2,-6,-4,71,343,20,56,53,-3,0,-2,3
GICRE,432,9,-28,221,-8,-44,-17,2,1,-4,-2,-16,72,218,19,56,38,2,2,5,6,-89,224,-12,-105,-63,-3,1,-7,-5,70,212,18,54,54,-3,0,-2,3
MPHASIS,433,7,-24,87,-8,-30,-17,2,1,0,-2,-6,72,87,11,66,59,-3,2,-1,4,-67,90,-7,-73,-55,-3,1,-4,1,32,89,-3,26,43,-3,0,-3,-2
UPL,434,6,15,152,15,29,-15,2,2,7,4,14,-28,159,-12,-14,-6,-3,1,-4,-4,74,137,14,88,59,-2,2,1,0,-69,159,-15,-55,-59,2,4,2,-3
NETWORK18,435,3,-26,220,-11,-32,-18,2,1,-1,1,-6,42,221,18,36,15,1,2,0,6,-66,220,6,-72,-63,-3,1,-5,-2,59,213,16,53,43,-3,0,-3,6
ALLCARGO,436,2,-25,85,7,-27,-39,2,3,-4,6,-2,66,89,14,64,54,-3,2,-1,0,-61,89,-13,-63,-35,-3,1,-6,-5,24,90,4,22,23,-3,0,-3,3
CERA,437,0,-34,285,16,-39,-59,2,3,0,4,-5,68,282,18,63,53,-3,0,-1,1,-18,284,15,-23,-29,-3,1,-2,0,-11,283,-12,-16,7,-3,1,-4,0
COFORGE,438,-3,-33,191,-16,-42,-17,2,1,-3,0,-9,80,189,18,71,58,-3,2,0,5,-90,192,-12,-99,-63,-3,-2,-5,-5,49,188,11,40,44,-3,0,-3,0
BALRAMCHIN,439,-9,-9,84,13,-8,-25,2,2,-2,1,1,54,92,14,55,46,-3,0,-1,-2,-32,83,-15,-31,-9,-3,-2,-4,1,-23,93,-6,-22,-19,-2,4,2,-2
NIACL,440,-10,-20,88,-8,-32,-9,2,1,-4,-2,-12,41,93,19,29,6,2,2,6,6,-92,96,-13,-104,-63,-3,-2,-6,-5,73,83,23,61,54,-3,0,-2,1
TECHM,441,-10,-34,93,-10,-43,-19,2,1,-4,-4,-9,72,90,10,63,59,-3,2,-1,5,-86,94,-10,-95,-63,-3,-2,-4,-4,47,87,13,38,43,-3,0,-4,-2
IIFL,442,-11,-16,219,18,-18,-48,2,3,4,5,-2,11,222,-18,9,38,-3,0,-3,-3,26,209,23,24,6,-3,0,0,0,-30,222,-16,-32,-12,-3,1,-3,3
ALKEM,443,-13,-43,222,-12,-49,-19,-3,-2,-4,-3,-6,91,211,19,85,59,2,2,4,5,-91,222,-13,-97,-63,-3,-2,-6,-4,36,216,-10,30,53,-3,0,-2,-2
HONASA,444,-16,-13,442,-8,-22,-15,2,3,0,5,-9,-21,446,-9,-30,-5,-2,-2,-2,-1,-36,440,-11,-45,-33,2,4,-1,3,63,438,13,54,46,-2,3,0,3
VIPIND,445,-20,14,56,16,11,-15,2,2,3,6,-3,7,59,-7,4,24,-3,-2,-5,0,4,56,-7,1,25,-3,-2,-5,-4,-42,61,-6,-45,-43,-2,4,1,4
KAYNES,446,-21,-47,448,-13,-65,-19,-3,-2,-7,-3,-18,95,438,24,77,62,-2,2,3,6,-79,448,-15,-97,-63,2,1,-2,-2,28,439,-10,10,42,-3,0,-4,3
ATUL,447,-22,-12,283,16,-3,-39,2,2,6,1,9,-12,287,-10,-3,9,-3,-2,-4,-2,73,267,16,82,43,2,2,4,6,-80,287,-13,-71,-63,-3,1,1,-3
KIMS,448,-25,-38,478,-11,-54,-19,2,-2,-6,-2,-16,82,473,19,66,58,-3,2,1,5,-83,479,-10,-99,-63,-3,-2,-6,1,30,476,-10,14,44,-3,0,-4,3
CGCL,449,-27,-38,476,13,-40,-59,2,3,-1,4,-2,51,477,13,49,40,-3,0,-3,4,-25,473,12,-27,-29,-3,1,-4,-2,-13,478,-15,-15,3,-3,1,-5,6
EPL,450,-28,-47,126,4,-46,-59,2,2,0,4,1,46,124,3,47,39,2,0,-3,5,-28,119,6,-27,-29,-3,1,-4,1,0,125,3,1,7,-3,1,-4,-4
KAJARIACER,451,-34,-55,382,-10,-53,-45,2,2,-1,-3,2,51,376,-3,53,54,-3,0,-1,4,-28,374,-8,-26,-19,-3,1,-3,4,-4,377,-12,-2,7,-3,1,-1,4
SHREECEM,452,-35,-23,443,4,-29,-25,1,0,-4,1,-6,60,440,3,54,54,1,2,-1,1,-80,447,-9,-86,-55,-3,-2,-6,-5,14,440,-7,8,23,-3,1,-3,3
RAMCOCEM,453,-38,-17,123,14,-14,-35,2,2,0,0,3,35,126,-3,38,40,-3,0,-3,4,-46,122,-4,-43,-29,-3,-2,-5,-3,-13,126,-13,-10,7,-3,1,-2,-3
CENTURYPLY,454,-40,-42,414,-8,-48,-41,2,1,-1,5,-6,72,412,16,66,54,-3,2,-1,4,-70,409,-7,-76,-63,2,3,-3,-2,6,413,-11,0,23,-3,1,-4,0
PATANJALI,455,-40,-59,95,-13,-70,-41,2,1,-6,-2,-11,77,88,18,66,57,-3,2,-1,4,-46,87,13,-57,-61,-3,1,1,3,-1,92,-8,-12,20,-3,-2,-5,-3
JKLAKSHMI,456,-41,-68,352,-12,-84,-43,-3,-2,-5,-3,-16,79,343,18,63,58,-3,2,-1,5,-68,349,-6,-84,-63,2,4,-3,-2,32,347,-7,16,44,-3,0,-5,3
3MINDIA,457,-46,-56,480,-8,-72,-43,2,-2,-6,1,-16,76,475,18,60,53,1,2,-2,4,-80,478,-9,-96,-63,-3,-2,-6,3,30,475,14,14,30,-3,-2,-5,-4
TVSSCS,458,-52,6,57,16,7,-25,2,2,6,5,1,-50,63,16,-49,-59,-2,-2,-2,-1,64,47,15,65,41,-3,2,5,4,-73,63,-10,-72,-63,-2,1,1,0
INFY,459,-53,-58,94,-13,-66,-41,2,4,-6,-4,-8,69,91,13,61,54,-3,2,-1,4,-68,91,-9,-76,-47,-3,0,-5,-4,12,91,-11,4,33,-3,0,-5,-2
IDEA,460,-58,-34,380,-8,-44,-17,-2,1,-5,-3,-10,-11,379,15,-21,-34,2,2,3,1,-9,373,9,-19,-31,2,4,6,1,6,379,16,-4,-1,-3,0,-4,-2
METROBRAND,461,-60,-58,128,-3,-65,-43,-3,-2,-4,-3,-7,78,122,21,71,53,-2,2,-1,5,-66,127,-10,-73,-61,2,4,1,-2,-7,127,-8,-14,10,-3,-2,-5,1
JUBLFOOD,462,-65,-40,92,-6,-37,-47,2,3,4,4,3,-5,95,-10,-2,14,-3,-2,-4,0,43,77,15,46,13,2,2,8,3,-66,95,-13,-63,-45,-3,1,-3,-3
CCL,463,-67,-65,499,-7,-75,-61,2,4,-1,-2,-10,72,497,18,62,54,-3,0,-2,5,-45,499,11,-55,-61,2,2,-1,2,-19,499,-8,-29,3,-3,-2,-6,-3
ZFCVINDIA,464,-67,-66,160,-7,-76,-43,-3,-2,-6,-5,-10,81,155,20,71,57,-3,2,1,4,-82,158,-10,-92,-63,-3,-2,-6,2,10,156,-7,0,30,-3,-2,-5,-3
AFFLE,465,-69,-68,319,-11,-77,-59,2,3,-1,-2,-9,62,317,14,53,48,-3,0,-1,4,-48,316,-6,-57,-29,-3,-2,-5,-3,-6,316,-10,-15,13,-3,1,-3,-4
BRITANNIA,466,-70,-65,223,-8,-76,-43,-3,-2,-6,-3,-11,72,217,18,61,57,-3,2,0,-2,-85,221,-8,-96,-63,-3,-2,-6,-3,19,220,-9,8,43,-3,-2,-5,-5
HAPPYFORGE,467,-73,-2,83,-3,5,-15,2,2,6,6,7,-79,96,-13,-72,-59,-2,-2,-2,-1,77,71,16,84,43,2,2,8,6,-76,96,-13,-69,-63,-2,1,0,1
INDIAMART,468,-79,-77,500,-8,-79,-63,-3,1,-1,-3,-2,54,498,10,52,46,-3,0,-3,4,-9,495,10,-11,-25,2,2,2,0,-45,500,-7,-47,-25,-3,-2,-4,-4
TV18BRDCST,469,-79,-58,30,-11,-67,-41,2,1,-6,-3,-9,39,27,18,30,13,1,2,-1,6,-74,29,-3,-83,-63,-3,1,-4,-2,23,26,-8,14,34,-3,-2,-4,6
DALBHARAT,470,-85,-62,384,-3,-71,-59,2,1,-5,2,-9,60,377,14,51,47,-3,0,-2,4,-61,380,-10,-70,-35,-3,-2,-6,-5,-13,381,-12,-22,7,-3,1,-4,-2
CLEAN,471,-98,-22,253,8,-26,-39,2,3,4,0,-4,-75,255,-6,-79,-65,-3,1,-3,1,77,237,18,73,43,2,2,6,6,-74,255,-7,-78,-65,-3,1,-1,1
PGHH,472,-98,-63,159,-7,-72,-43,-3,-2,-5,-3,-9,69,157,18,60,53,-3,2,-1,0,-83,159,-7,-92,-63,-3,1,-7,-4,-12,158,-10,-21,9,-3,-2,-4,-2
BATAINDIA,473,-99,-49,254,-11,-40,-49,2,3,3,3,9,-12,254,-7,-3,7,-3,-2,-5,-2,43,243,17,52,11,2,2,6,5,-90,256,-15,-81,-65,-3,1,-4,-4
BLUEDART,474,-101,-32,444,-7,-35,-33,2,2,4,0,-3,7,444,-8,4,24,-3,-2,-4,0,-4,438,-7,-7,-3,2,3,4,-3,-69,448,-14,-72,-45,-3,1,-4,-4
MEDPLUS,475,-118,-20,474,-4,-17,-25,-2,2,4,5,3,-66,480,8,-63,-65,-2,-2,-3,-2,34,462,11,37,9,2,2,5,5,-69,479,-10,-66,-63,-2,4,1,1
ANURAS,476,-124,-83,320,-12,-85,-63,-3,-2,-6,3,-2,55,316,9,53,47,-3,0,-2,4,-73,319,-12,-75,-63,2,3,-1,-2,-21,317,-13,-23,3,-3,-2,-5,-1
CAMPUS,477,-132,-22,378,4,-21,-39,2,3,5,3,1,-76,383,-11,-75,-59,-2,1,-4,-1,40,365,12,41,17,-2,2,7,4,-75,383,-8,-74,-66,-2,1,0,0
ASIANPAINT,478,-138,-64,256,-10,-65,-59,2,3,0,0,-1,27,253,-3,26,38,-3,-2,-3,0,-56,255,-8,-57,-35,-3,-2,-5,-3,-44,253,-12,-45,-21,-3,1,-5,-4
IBULHSGFIN,479,-141,-47,446,-8,-46,-39,2,2,-4,0,1,-33,448,7,-32,-47,1,2,0,4,-58,443,-8,-57,-35,-3,-2,-6,-4,-4,441,13,-3,-10,-3,1,-3,-2
TTML,480,-141,-74,31,-11,-83,-61,2,1,-5,0,-9,60,25,15,51,46,-3,0,-3,5,-81,31,-12,-90,-55,-3,-2,-6,-3,-37,30,-10,-46,-25,-3,1,-4,4
LTIM,481,-145,-80,96,-15,-110,-61,2,4,-6,-4,-30,49,94,10,19,48,-3,0,-4,-2,-66,95,4,-96,-61,-3,-2,-5,1,-18,94,-10,-48,7,-3,-2,-6,-4
VAIBHAVGBL,482,-158,-54,288,-13,-63,-42,2,1,-6,4,-9,26,286,10,17,16,-3,2,-3,4,-90,288,-13,-99,-63,-3,1,-7,-5,-31,285,-10,-40,-15,-3,-2,-4,3
GLAND,483,-167,-37,379,-10,-42,-17,2,-2,-5,-5,-5,-47,382,4,-52,-60,2,3,0,4,-79,384,-13,-84,-63,-3,1,-2,1,1,378,14,-4,-1,-3,0,-4,-5
KRBL,484,-172,-64,479,-8,-69,-59,2,2,-1,0,-5,19,478,-7,14,28,-3,0,-3,4,-55,474,-13,-60,-29,-3,-2,-6,-2,-67,480,-12,-72,-45,-3,1,-5,-3
KANSAINER,485,-178,-55,29,-13,-57,-47,2,3,0,0,-2,-27,31,-8,-29,-13,-3,-2,-4,3,-8,26,-8,-10,3,-3,2,-3,1,-86,31,-13,-88,-65,-3,1,-3,-3
TATATECH,486,-185,-6,59,13,-5,-27,2,2,1,3,1,-78,64,-13,-77,-58,-2,-2,-2,-1,-26,58,-4,-25,-9,-3,-2,-5,-3,-76,64,-13,-75,-63,-2,1,1,0
BERGEPAINT,487,-188,-55,447,10,-55,-63,2,-2,-3,1,0,-5,445,-8,-5,8,-3,-2,-4,4,-78,445,-7,-78,-63,2,-2,-5,-3,-50,447,4,-50,-49,-3,1,-4,1
ATGL,488,-193,-61,64,-6,-70,-53,2,1,-5,0,-9,3,60,-15,-6,18,-3,4,-2,1,-88,64,-9,-97,-63,-3,-2,-7,-4,-38,62,16,-47,-48,-3,0,-1,-2
AWL,489,-197,-54,381,4,-53,-59,2,3,-4,0,1,-29,381,10,-28,-39,-2,1,-3,4,-56,376,-13,-55,-29,-3,-2,-4,-5,-59,382,8,-58,-70,2,1,0,0
PEL,490,-205,-56,127,-7,-59,-59,2,3,0,5,-3,-35,128,-7,-38,-21,-3,-2,-5,3,-31,120,-8,-34,-15,-3,0,-3,-2,-80,128,-10,-83,-65,-3,1,-4,1
RAJESHEXPO,491,-231,-60,318,-7,-65,-56,2,3,0,-2,-5,-58,320,-10,-63,-36,-3,1,-6,-4,-29,313,-12,-34,-5,-3,-2,-5,-2,-79,320,-15,-84,-68,2,4,0,-2
INDIGOPNTS,492,-233,-60,287,-8,-62,-55,2,3,0,-2,-2,-70,288,-8,-72,-65,2,1,-1,1,-22,285,4,-24,-29,-3,4,-1,3,-79,288,-6,-81,-65,-3,1,-4,-2
STARHEALTH,493,-251,-58,255,-13,-61,-45,1,2,-4,1,-3,-85,256,-15,-88,-65,-2,1,-1,-3,-31,253,-8,-34,-9,-3,-2,-5,-4,-74,254,-12,-77,-69,2,4,0,1
MANYAVAR,494,-251,-72,192,-10,-82,-62,2,1,-1,-2,-10,-31,192,-10,-41,-10,-2,-2,-5,-2,-66,189,-7,-76,-63,2,3,-1,0,-72,192,-13,-82,-45,-3,1,-7,-5
HINDUNILVR,495,-266,-81,415,-16,-93,-63,2,1,-5,0,-12,-6,415,-7,-18,14,-3,-2,-5,-3,-90,413,-11,-102,-63,-3,-2,-6,-5,-77,415,-12,-89,-49,-3,-2,-7,-4
NUVOCO,496,-280,-64,383,-10,-66,-59,2,3,0,0,-2,-81,384,-10,-83,-66,-3,-2,-3,3,-56,377,-7,-58,-35,-3,-2,-5,-4,-77,384,-6,-79,-65,-3,1,-5,1
ZEEL,497,-297,-58,158,-8,-60,-59,2,3,-1,5,-2,-88,160,-9,-90,-66,-3,-2,-6,-2,-58,157,-10,-60,-35,-3,-2,-6,-2,-91,160,-13,-93,-65,-3,1,-6,-5
DABUR,498,-300,-95,416,-16,-140,-63,-3,-2,-7,-4,-45,-5,416,-7,-50,14,-3,-2,-5,-2,-84,416,-15,-129,-63,1,1,-6,-2,-71,416,-7,-116,-49,-3,-2,-5,-5
BANDHANBNK,499,-336,-79,501,-16,-85,-62,2,1,-2,-2,-6,-90,501,-9,-96,-68,-3,-2,-6,-2,-76,500,-14,-82,-63,-2,4,-4,3,-85,501,-8,-91,-65,-3,1,-5,-5
RBA,500,-350,-89,32,-10,-105,-63,-3,-2,-6,-5,-16,-68,32,8,-84,-66,-3,-2,-6,1,-88,32,-15,-104,-63,-3,1,-7,-1,-89,32,-10,-105,-69,-3,-2,-6,1
PAYTM,501,-356,-75,224,-8,-84,-64,1,1,-5,0,-9,-92,224,-13,-101,-68,-2,-2,-5,-2,-92,223,-14,-101,-63,-3,1,-8,-5,-88,224,-16,-97,-65,-3,4,-6,-2
