symbol,allRank,allPoints,d_IndicatorPoints,d_Rank,d_adxPoints,d_allPoints,d_emaPoints,d_kstPoints,d_macdPoints,d_rsiPoints,d_volumePoints,hl_BreakoutPoints,m_IndicatorPoints,m_Rank,m_adxPoints,m_allPoints,m_emaPoints,m_kstPoints,m_macdPoints,m_rsiPoints,m_volumePoints,min75_IndicatorPoints,min75_Rank,min75_adxPoints,min75_allPoints,min75_emaPoints,min75_kstPoints,min75_macdPoints,min75_rsiPoints,min75_volumePoints,w_IndicatorPoints,w_Rank,w_adxPoints,w_allPoints,w_emaPoints,w_kstPoints,w_macdPoints,w_rsiPoints,w_volumePoints
BEL,1,835,100,33,17,193,64,2,2,9,6,93,330,33,26,423,65,2,2,9,6,100,34,24,193,61,2,2,7,4,212,34,21,305,69,2,2,8,4
TORNTPOWER,2,834,105,65,24,195,63,2,2,8,6,90,330,65,26,420,65,2,2,9,6,79,66,20,169,59,-3,2,0,1,230,65,26,320,70,2,2,9,6
ABB,3,833,100,34,24,193,63,-3,2,8,6,93,330,34,26,423,65,2,2,9,6,92,35,17,185,61,2,2,6,4,218,33,21,311,69,2,2,9,6
KSB,4,823,97,449,16,189,63,2,2,8,6,92,330,449,26,422,65,2,2,9,6,108,449,26,200,63,2,2,9,6,196,451,18,288,69,-2,2,8,3
MOTILALOFS,5,823,100,385,19,190,63,2,2,8,6,90,315,385,21,405,65,2,2,9,6,92,385,20,182,64,-2,2,4,4,226,385,24,316,70,2,2,9,6
THERMAX,6,823,106,226,24,193,63,2,2,9,6,87,330,225,26,417,65,2,2,9,6,80,226,19,167,59,-3,3,2,0,220,225,23,307,69,2,2,9,5
EXIDEIND,7,822,105,1,23,198,63,2,2,9,6,93,315,2,21,408,65,2,2,9,6,101,1,28,194,63,-2,2,9,1,208,2,21,301,69,-2,2,9,5
CUMMINSIND,8,820,92,451,18,182,64,-2,2,5,5,90,330,450,28,420,65,2,2,9,4,92,451,15,182,63,2,2,5,5,216,449,24,306,65,2,2,9,6
HAL,9,820,99,322,17,177,64,2,2,8,6,78,336,321,28,414,65,2,2,9,6,91,322,18,169,61,-2,2,8,4,216,321,21,294,70,2,2,9,4
KEI,10,815,99,289,17,192,63,2,2,9,6,93,324,290,24,417,65,2,2,9,6,99,289,21,192,63,2,2,7,4,200,291,16,293,69,2,2,8,3
HINDZINC,11,808,106,225,25,199,62,2,2,9,6,93,294,227,17,387,66,2,2,8,3,105,225,26,198,63,2,2,6,6,210,226,18,303,69,2,2,9,5
SUNDARMFIN,12,808,98,3,17,189,63,2,2,8,6,91,315,3,21,406,65,2,2,9,6,88,3,23,179,63,-2,2,3,-1,216,1,24,307,69,2,2,8,3
PHOENIXLTD,13,806,95,481,15,187,63,2,2,8,5,92,324,481,24,416,65,2,2,9,6,99,481,26,191,61,2,2,6,2,196,482,20,288,69,-2,2,8,1
TATAPOWER,14,806,97,257,16,189,63,2,2,8,6,92,303,259,21,395,65,-2,2,9,6,98,257,24,190,63,2,2,2,5,216,257,23,308,69,2,2,8,4
BLUESTARCO,15,801,96,290,19,184,64,2,2,4,5,88,330,289,26,418,65,2,2,9,6,65,291,18,153,47,-3,0,-2,5,222,289,24,310,69,2,2,8,6
KPIL,16,800,96,163,20,183,63,2,2,4,5,87,318,162,23,405,64,2,2,9,6,75,162,19,162,55,-3,2,-2,4,224,161,24,311,69,2,2,9,6
GAIL,17,795,95,417,16,184,63,2,2,7,5,89,315,417,21,404,65,2,2,9,6,74,418,19,163,55,-3,0,0,3,222,417,24,311,69,2,2,9,5
GODREJPROP,18,794,102,161,21,192,63,2,2,8,6,90,303,165,19,393,65,2,2,8,5,81,161,21,171,59,-3,2,1,1,218,162,23,308,69,2,2,8,5
AEGISCHEM,19,794,98,35,17,191,63,2,2,8,6,93,291,36,15,384,65,2,2,8,5,108,33,26,201,63,2,2,9,6,204,35,16,297,69,2,2,8,5
SIEMENS,20,790,98,194,21,183,63,1,2,5,6,85,330,193,26,415,65,2,2,9,6,49,194,14,134,47,-3,-2,-3,-4,228,193,26,313,69,2,2,9,6
SAIL,21,789,97,450,16,189,63,2,2,8,6,92,300,451,16,392,65,2,2,9,6,94,450,21,186,61,-2,2,8,4,206,450,17,298,69,2,2,8,5
TATAMOTORS,22,789,88,130,13,173,63,-3,2,7,6,85,321,129,23,406,65,2,2,9,6,83,129,16,168,61,1,2,2,1,212,129,26,297,65,2,2,6,5
DIXON,23,788,101,323,19,173,64,2,2,8,6,72,318,322,23,390,65,2,2,8,6,79,323,18,151,55,2,2,-1,3,218,323,21,290,69,2,2,9,6
NTPC,24,788,98,259,17,185,63,2,2,8,6,87,330,257,26,417,65,2,2,9,6,69,259,21,156,55,-3,0,-2,-2,204,259,24,291,69,-3,2,5,5
INDIGO,25,787,101,291,21,178,64,2,2,7,5,77,312,291,21,389,65,2,2,9,5,79,290,24,156,55,2,2,-2,-2,218,290,21,295,69,2,2,9,6
BSE,26,783,99,260,19,173,63,2,2,7,6,74,330,258,26,404,65,2,2,9,6,74,260,18,148,55,-3,2,-1,3,206,262,21,280,70,-3,2,8,5
PETRONET,27,782,100,97,19,192,63,2,2,8,6,92,285,100,14,377,65,2,2,8,4,95,97,21,187,63,2,2,2,5,210,97,19,302,69,2,2,8,5
CENTURYTEX,28,781,97,162,17,187,63,2,2,7,6,90,315,163,21,405,65,2,2,9,6,63,163,18,153,49,-3,0,-2,1,216,163,21,306,69,2,2,8,6
MAHLIFE,29,779,100,321,19,190,63,2,2,8,6,90,297,323,21,387,65,-3,2,8,6,92,321,16,182,61,2,2,7,4,200,322,15,290,69,2,2,8,4
"M&M",30,779,97,227,18,187,63,2,2,7,5,90,315,226,21,405,65,2,2,9,6,69,228,18,159,55,-3,0,0,-1,208,227,19,298,69,2,2,8,4
JSWENERGY,31,778,97,258,17,187,63,2,2,8,5,90,297,260,21,387,65,-3,2,9,5,78,258,21,168,55,-3,2,-1,4,216,258,21,306,69,2,2,9,5
MCDOWELL-N,32,778,91,193,13,183,63,2,2,5,6,92,303,194,18,395,65,2,2,8,6,92,193,16,184,63,2,2,4,5,200,194,18,292,70,-2,2,8,4
COCHINSHIP,33,776,97,482,17,167,63,2,2,7,6,70,330,482,26,400,65,2,2,9,6,61,482,20,131,47,-3,0,-2,-1,218,481,26,288,69,-3,2,9,6
BAJAJ-AUTO,34,775,85,5,18,164,62,-3,2,3,3,79,318,5,23,397,64,2,2,9,6,87,4,12,166,63,2,2,4,4,206,4,24,285,66,2,2,4,5
GLENMARK,35,771,98,228,16,173,63,2,2,9,6,75,306,228,19,381,65,2,2,9,5,88,227,21,163,61,-3,2,3,4,204,228,16,279,69,2,2,9,4
CASTROLIND,36,769,95,131,15,170,63,2,2,7,6,75,303,131,19,378,65,2,2,8,5,82,131,19,157,59,-3,2,1,4,214,131,21,289,69,2,2,8,5
EICHERMOT,37,768,99,2,19,191,63,2,2,8,5,92,285,6,15,377,65,2,2,8,3,94,2,21,186,63,1,2,2,5,198,3,13,290,70,2,2,8,4
HEG,38,766,103,354,21,157,63,2,2,9,6,54,291,355,15,345,65,2,2,8,5,104,353,24,158,64,2,2,8,4,214,354,21,268,69,2,2,8,5
IRCTC,39,766,98,6,17,153,63,2,2,8,6,55,303,7,23,358,66,-3,2,8,5,100,5,21,155,63,2,2,7,5,210,6,21,265,69,2,2,8,3
TATAMTRDVR,40,762,87,166,13,169,63,-3,2,6,6,82,327,161,25,409,65,2,2,9,6,68,164,15,150,55,-3,2,-1,0,198,166,24,280,66,-3,2,5,5
DATAPATTNS,41,760,97,69,16,146,63,2,2,8,6,49,300,69,21,349,65,-2,2,8,6,102,67,24,151,63,2,2,5,6,212,70,19,261,69,2,2,8,6
ANANDRATHI,42,756,94,231,16,141,64,2,2,7,3,47,324,230,28,371,65,-2,2,9,6,97,230,21,144,63,2,2,8,1,194,232,24,241,65,-3,2,6,3
HINDCOPPER,43,756,98,66,16,188,63,2,2,9,6,90,255,70,23,345,44,2,2,9,5,97,65,26,187,64,-2,2,4,3,216,66,21,306,70,2,2,9,4
VGUARD,44,754,92,129,12,179,63,2,2,7,6,87,291,132,15,378,65,2,2,8,5,78,130,21,165,55,-3,2,-1,4,206,130,15,293,70,2,2,8,6
INDHOTEL,45,747,68,67,-7,156,64,-2,2,6,5,88,330,66,26,418,65,2,2,9,6,53,68,-15,141,61,2,2,5,-2,208,67,21,296,65,2,2,9,5
IPCALAB,46,745,97,324,16,151,63,2,2,8,6,54,303,324,19,357,65,2,2,8,5,85,324,20,139,59,-2,2,1,5,206,324,20,260,69,-2,2,8,6
BHARTIARTL,47,742,62,421,-4,142,61,-2,2,2,3,80,318,418,21,398,66,2,2,9,6,82,419,14,162,63,2,2,3,-2,200,419,24,280,65,1,2,4,4
MUTHOOTFIN,48,737,104,99,24,153,63,2,2,7,6,49,294,101,17,343,65,2,2,8,4,86,98,19,135,61,-3,2,4,3,204,101,17,253,69,2,2,8,4
360ONE,49,736,97,358,16,112,63,2,2,8,6,15,318,356,24,333,65,2,2,8,5,102,354,24,117,63,2,2,7,4,204,357,21,219,69,-2,2,8,4
NATIONALUM,50,729,95,164,17,181,63,2,2,5,6,86,309,164,19,395,65,2,2,9,6,29,166,-8,115,47,-3,0,-4,-3,210,164,19,296,69,2,2,8,5
VOLTAS,51,727,99,356,19,141,63,2,2,7,6,42,291,357,16,333,65,2,2,8,4,73,355,20,115,55,-3,0,0,1,222,355,23,264,69,2,2,9,6
DMART,52,726,103,388,21,157,63,2,2,9,6,54,267,391,13,321,65,-2,2,8,3,86,386,19,140,61,-3,2,3,4,216,388,21,270,69,2,2,9,5
JINDALSTEL,53,725,91,386,15,176,64,2,2,4,4,85,306,386,19,391,65,2,2,9,5,33,388,-5,118,47,-3,1,-3,-4,210,386,19,295,69,2,2,8,5
BHEL,54,724,95,418,13,182,64,2,2,8,6,87,261,419,23,348,45,2,2,9,6,83,417,16,170,59,2,2,0,4,198,418,21,285,69,-3,2,5,5
VEDL,55,723,105,419,23,150,63,2,2,9,6,45,255,424,10,300,66,-2,2,8,1,108,420,26,153,63,2,2,9,6,210,420,18,255,69,2,2,9,5
TRENT,56,723,88,172,15,97,63,-2,2,7,3,9,336,167,28,345,65,2,2,9,6,92,171,17,101,63,2,2,7,1,198,170,24,207,65,-3,2,6,5
ICICIBANK,57,723,79,132,6,159,63,-2,2,6,4,80,288,133,18,368,66,-3,2,8,5,74,132,14,154,61,-3,0,2,0,202,132,18,282,66,2,2,8,5
CANBK,58,723,90,4,13,171,64,2,2,4,5,81,327,1,26,408,64,2,2,9,6,29,7,-7,110,39,-3,0,-4,4,196,5,19,277,66,2,2,4,5
MAXHEALTH,59,722,98,266,17,113,63,2,2,8,6,15,315,264,26,330,65,-2,2,9,5,100,265,21,115,63,2,2,7,5,194,268,16,209,69,2,2,8,0
JBCHEPHARM,60,722,98,9,16,113,63,2,2,9,6,15,312,10,24,327,65,-2,2,9,6,101,6,19,116,63,2,2,9,6,196,11,17,211,69,-2,2,8,4
ASTERDM,61,721,95,422,17,108,63,2,2,8,3,13,309,421,19,322,65,2,2,9,6,100,422,26,113,63,-3,2,8,4,204,421,24,217,69,-2,2,5,4
BRIGADE,62,721,96,395,16,106,63,2,2,7,6,10,324,389,24,334,65,2,2,9,6,95,392,21,105,63,2,2,4,3,196,393,20,206,69,-3,2,5,5
KALYANKJIL,63,718,95,355,15,147,64,2,2,6,6,52,324,354,24,376,65,2,2,9,6,45,357,-11,97,47,2,3,4,0,202,356,23,254,70,-3,2,5,4
JUBLINGREA,64,716,99,230,17,143,63,2,2,9,6,44,270,232,13,314,66,-2,2,6,5,105,229,24,149,64,2,2,7,6,198,231,14,242,69,2,2,7,5
SCHNEIDER,65,716,87,98,21,169,59,1,2,-1,5,82,336,97,28,418,65,2,2,9,6,-5,105,-8,77,15,-3,-2,-6,-1,216,98,26,298,69,2,2,4,5
NAM-INDIA,66,712,98,198,17,112,63,2,2,8,6,14,306,199,19,320,65,2,2,8,6,88,198,24,102,59,-3,2,1,5,206,197,24,220,69,-2,2,5,5
CHALET,67,711,98,203,18,101,63,2,2,7,6,3,324,197,24,327,65,2,2,9,6,82,202,9,85,63,2,2,4,2,204,199,24,207,70,-3,2,4,5
POWERINDIA,68,710,94,100,21,149,63,2,2,1,5,55,330,99,26,385,65,2,2,9,6,15,109,-13,70,39,-3,0,-5,-3,216,99,21,271,69,2,2,9,5
PNB,69,708,95,261,15,169,64,2,2,6,6,74,258,262,23,332,44,2,2,9,6,73,261,16,147,55,-3,2,-2,5,208,260,24,282,66,2,2,5,5
REDINGTON,70,704,88,262,13,168,63,2,2,3,5,80,288,261,19,368,66,-3,2,8,4,48,264,13,128,39,-3,0,-4,3,200,261,18,280,65,2,2,8,5
VTL,71,704,96,167,15,138,63,2,2,8,6,42,276,170,10,318,65,2,2,8,5,96,165,17,138,63,2,2,8,4,194,167,11,236,69,2,2,8,5
IRB,72,702,96,11,16,106,64,2,2,6,6,10,330,9,26,340,65,2,2,9,6,64,15,24,74,47,-3,0,-2,-2,202,10,19,212,69,-3,2,8,6
KARURVYSYA,73,701,93,171,14,102,63,2,2,6,6,9,321,168,24,330,65,2,2,9,5,80,175,18,89,61,-3,0,1,3,198,169,23,207,69,-3,2,4,4
GRAPHITE,74,701,87,8,16,133,61,2,2,0,6,46,297,8,16,343,65,2,2,8,6,55,8,21,101,39,-3,0,-5,3,216,7,23,262,69,2,2,8,4
CDSL,75,698,92,298,14,107,63,2,2,8,3,15,300,296,21,315,66,-2,2,8,5,103,294,21,118,63,2,2,9,6,188,298,19,203,69,-3,2,4,3
RADICO,76,698,96,199,16,111,63,2,2,8,5,15,294,201,21,309,65,-2,2,8,4,95,195,17,110,63,2,2,7,4,198,198,18,213,69,-2,2,8,4
ICICIPRULI,77,693,100,293,18,149,64,2,2,8,6,49,273,295,9,322,66,2,2,7,5,73,293,18,122,55,-3,2,-2,3,198,294,14,247,69,2,2,8,4
GPIL,78,690,97,484,16,111,63,2,2,8,6,14,282,489,21,296,59,-3,2,9,6,99,483,21,113,63,2,2,5,6,198,485,19,212,69,-3,2,8,4
MCX,79,689,96,170,16,105,63,2,2,7,6,9,309,169,19,318,65,2,2,9,6,81,174,21,90,55,1,2,-2,4,194,172,19,203,70,-3,2,5,4
TATASTEEL,80,688,93,165,16,177,64,2,2,4,5,84,285,166,17,369,65,-2,2,8,5,16,172,-10,100,39,-3,-2,-4,-4,210,165,19,294,69,2,2,8,5
BEML,81,687,95,136,16,106,63,2,2,6,6,11,306,135,19,317,65,2,2,8,6,81,136,24,92,55,-3,2,-1,4,194,136,21,205,69,-3,2,4,4
POONAWALLA,82,686,87,140,11,96,63,2,2,5,4,9,294,141,21,303,65,-3,2,8,5,86,135,16,95,61,-3,2,6,4,210,135,20,219,69,2,2,7,5
ACE,83,684,71,36,13,156,55,-3,2,-1,5,85,336,35,28,421,65,2,2,9,6,-14,46,-15,71,9,-3,1,-3,-3,206,36,24,291,65,2,2,4,6
MANAPPURAM,84,682,97,391,16,141,63,2,2,8,6,44,273,393,11,317,65,2,2,7,4,72,389,21,116,55,-3,2,-1,-2,196,391,16,240,69,-2,2,8,5
CESC,85,681,99,297,19,110,63,2,2,7,6,11,297,297,17,308,65,2,2,8,5,78,300,23,89,55,-3,2,0,1,196,296,19,207,69,-3,2,8,3
NAUKRI,86,676,94,390,17,143,63,2,2,5,5,49,297,388,17,346,65,2,2,8,5,28,400,-13,77,47,-3,0,-3,0,208,390,19,257,69,2,2,8,4
JINDALSAW,87,675,95,169,15,107,63,2,2,7,6,12,291,171,24,303,59,2,2,4,6,91,169,16,103,61,2,2,6,4,186,173,16,198,70,-3,2,4,4
NUVAMA,88,674,103,264,21,139,63,2,2,9,6,36,258,270,18,294,65,-2,2,1,2,99,263,20,135,63,2,2,8,4,178,265,17,214,59,-2,2,9,4
"ARE&M",89,673,98,201,17,105,63,2,2,8,6,7,279,206,18,286,64,2,2,7,0,97,197,26,104,63,-3,2,5,4,192,202,17,199,69,-2,2,7,3
TATACHEM,90,672,89,392,16,123,63,-2,2,5,5,34,288,390,19,322,66,-3,2,7,5,65,395,18,99,55,-3,0,-2,-3,196,392,16,230,69,2,2,5,4
HONAUT,91,672,101,294,19,146,63,2,2,9,6,45,255,300,10,300,66,-2,2,6,3,87,292,23,132,59,-3,2,1,5,184,295,14,229,61,2,2,8,5
GODREJIND,92,670,93,137,16,102,63,2,2,4,6,9,309,134,21,318,65,2,2,7,6,63,138,20,72,47,-3,0,-1,0,196,137,21,205,69,-3,2,5,4
JUSTDIAL,93,669,95,454,17,100,63,2,2,5,6,5,288,460,15,293,65,2,2,6,6,69,455,19,74,49,-3,2,-1,3,212,453,19,217,70,2,2,7,6
LINDEINDIA,94,668,77,389,16,157,59,-3,2,0,3,80,306,387,24,386,65,-3,2,9,5,-3,401,-8,77,15,-3,-2,-3,-2,208,387,17,288,69,2,2,8,6
SOBHA,95,666,95,40,16,101,64,2,2,6,5,6,306,38,19,312,64,2,2,9,6,57,48,16,63,49,-3,0,-2,-3,202,38,23,208,69,-3,2,5,5
ADANIPOWER,96,665,84,195,16,168,61,2,2,-1,4,84,300,195,21,384,65,-2,2,8,6,3,201,-9,87,25,-3,-2,-5,-3,194,195,19,278,70,-3,2,4,5
BDL,97,665,79,50,3,79,63,2,2,4,5,0,324,37,24,324,65,2,2,9,6,84,41,16,84,59,2,2,2,3,178,48,18,178,65,-3,2,3,4
LODHA,98,663,85,425,9,91,63,2,2,5,4,6,315,422,21,321,65,2,2,9,6,67,427,18,73,49,-2,0,-1,3,190,425,18,196,69,-3,2,4,5
EIHOTEL,99,662,91,236,18,100,63,2,2,1,5,9,318,231,23,327,64,2,2,9,6,24,246,-8,33,39,-2,0,-5,0,220,234,26,229,65,2,2,9,6
LICHSGFIN,100,662,96,106,17,100,63,2,2,7,5,4,297,106,16,301,65,2,2,8,6,67,107,16,71,55,-3,2,-1,-2,198,104,21,202,69,-3,2,5,5
JIOFIN,101,660,92,71,19,117,61,-3,2,8,5,25,255,77,18,280,64,-2,2,1,2,88,69,21,113,61,-3,2,2,5,200,71,26,225,55,2,2,9,6
SRF,102,659,92,232,13,124,63,2,2,7,5,32,264,238,15,296,66,-3,2,7,1,73,232,16,105,55,2,2,-2,0,198,233,13,230,69,2,2,8,5
ZOMATO,103,659,98,229,19,149,63,2,2,7,5,51,222,246,19,273,36,2,2,9,6,70,231,16,121,55,-3,0,-1,3,218,229,21,269,70,2,2,9,5
FDC,104,658,80,400,3,82,63,2,2,5,5,2,303,395,18,305,65,2,2,8,6,75,399,14,77,61,-3,0,2,1,198,395,23,200,69,-3,2,3,5
INOXWIND,105,656,93,487,15,97,63,2,2,5,6,4,270,491,26,274,45,2,2,9,6,99,484,21,103,63,2,2,7,4,190,488,19,194,69,-3,2,5,3
TRITURBINE,106,656,85,452,18,162,59,2,2,0,4,77,291,452,18,368,65,-2,2,8,6,-5,456,-9,72,15,-2,-2,-5,-2,208,452,17,285,69,2,2,8,6
MEDANTA,107,656,94,235,15,101,64,2,2,6,5,7,300,233,24,307,64,-2,2,6,6,67,236,16,74,55,-3,2,0,-3,188,236,24,195,60,-2,2,5,5
APARINDS,108,655,85,353,16,161,61,2,2,-1,5,76,306,353,24,382,59,2,2,9,6,-8,361,-11,68,15,-3,-2,-5,-2,196,353,20,272,70,-2,2,4,4
NBCC,109,655,90,142,15,91,63,2,2,3,5,1,312,137,21,313,64,2,2,9,6,58,144,16,59,47,-3,0,-2,0,194,142,24,195,65,-3,2,3,6
MAZDOCK,110,653,87,173,16,96,55,2,2,6,6,9,294,172,26,303,59,1,2,4,6,77,176,23,86,55,-3,0,-1,3,186,174,18,195,67,-3,2,6,3
KEC,111,652,95,267,19,111,63,2,2,3,6,16,315,263,21,331,66,2,2,8,6,8,280,-8,24,25,-3,-2,-4,0,218,263,23,234,69,2,2,8,5
SCHAEFFLER,112,652,96,197,17,114,63,2,2,8,4,18,288,202,24,306,66,-3,2,4,3,72,200,9,90,61,-3,2,0,3,178,204,9,196,69,2,2,6,1
HINDALCO,113,652,97,135,16,111,63,2,2,8,6,14,267,144,16,281,65,-3,2,6,3,86,134,21,100,59,2,2,0,2,188,138,17,202,70,-3,2,7,1
PNCINFRA,114,651,90,239,16,88,63,2,2,3,4,-2,303,236,18,301,66,2,2,8,5,64,241,15,62,47,-3,3,1,1,196,237,16,194,65,2,2,8,5
"M&MFIN",115,650,97,102,16,124,63,2,2,8,6,27,267,107,14,294,65,-3,2,7,4,83,99,23,110,59,-3,2,1,1,176,103,5,203,69,2,2,6,4
WELCORP,116,649,90,455,15,99,63,2,2,3,5,9,303,457,24,312,59,2,2,8,6,67,454,11,76,59,-3,2,1,-3,180,461,16,189,70,-3,2,2,3
EIDPARRY,117,649,94,424,15,101,63,2,2,7,5,7,267,431,14,274,65,-3,2,5,6,93,423,18,100,63,1,2,4,5,188,426,17,195,69,-3,2,6,3
ELGIEQUIP,118,649,76,47,13,83,49,2,2,4,6,7,294,41,20,301,65,-3,2,8,6,86,39,12,93,63,2,2,3,4,186,41,18,193,65,2,2,2,4
ABCAPITAL,119,647,97,387,17,169,63,2,2,7,6,72,225,398,18,297,45,-2,2,8,4,61,387,18,133,49,-3,2,-1,-4,192,389,12,264,69,2,2,7,4
COALINDIA,120,647,82,174,4,91,63,2,2,6,5,9,267,179,26,276,44,2,2,9,6,93,170,16,102,63,2,2,4,6,196,171,24,205,66,-3,2,5,4
TATAINVEST,121,647,48,114,12,52,36,-3,3,-1,1,4,336,102,28,340,65,2,2,9,6,59,110,10,63,45,-3,3,1,3,200,102,23,204,65,2,2,2,6
CAMS,122,645,82,331,6,87,63,2,2,5,4,5,288,327,14,293,65,2,2,7,6,84,328,16,89,59,2,2,2,3,186,327,18,191,69,-3,2,3,4
NHPC,123,644,79,108,3,83,63,2,2,3,6,4,330,103,26,334,65,2,2,9,6,47,111,10,51,39,-2,0,-4,4,184,107,21,188,66,-2,2,4,1
AARTIIND,124,643,98,420,17,143,63,2,2,8,6,45,231,430,16,276,45,2,2,7,5,101,421,19,146,63,2,2,9,6,168,422,19,213,48,2,2,8,5
HUDCO,125,640,86,459,11,87,62,2,2,3,6,1,330,453,26,331,65,2,2,9,6,25,466,-10,26,39,-3,0,-2,1,198,458,24,199,65,-2,2,5,5
LUPIN,126,640,67,402,8,67,47,-2,3,5,6,0,297,399,21,297,59,2,2,9,6,80,397,15,80,61,2,2,2,-2,196,397,24,196,66,-3,2,4,5
UBL,127,638,92,423,14,104,63,2,2,8,3,12,273,428,15,285,65,-3,2,7,5,73,425,11,85,59,-2,2,0,3,188,423,14,200,69,-2,2,7,4
ADANIPORTS,128,637,65,70,9,137,57,1,2,-2,-2,72,318,67,21,390,66,2,2,9,6,-14,74,-10,58,9,-3,-2,-6,-2,196,69,21,268,65,2,2,4,4
GODFRYPHLP,129,636,56,134,13,128,50,-3,0,-4,0,72,327,130,26,399,65,2,2,9,5,-13,145,12,59,-19,-3,1,-5,1,194,133,24,266,65,2,2,1,3
CONCORDBIO,130,635,99,296,19,112,63,2,2,7,6,13,258,305,18,271,65,-2,2,1,2,85,298,19,98,61,2,2,-1,2,180,301,23,193,59,-3,2,5,4
PIDILITIND,131,634,78,292,16,153,59,-3,2,-1,5,75,279,293,16,354,65,-2,2,8,4,-4,305,-4,71,15,-3,-2,-6,-4,206,292,19,281,69,2,2,8,3
NLCINDIA,132,634,84,45,8,84,63,2,2,4,5,0,294,42,24,294,59,2,2,8,3,72,45,18,72,55,-2,2,-2,1,184,45,18,184,70,-3,2,4,1
RAINBOW,133,632,91,141,18,95,63,2,2,3,3,4,297,142,23,301,65,-2,2,6,5,22,149,7,26,25,-2,-2,-4,-2,218,134,24,222,69,2,2,7,5
NSLNISP,134,632,94,105,15,103,63,2,2,6,6,9,282,108,19,291,65,-2,2,4,6,81,104,21,90,59,-3,2,-1,3,166,110,16,175,59,-2,2,7,1
POLYCAB,135,631,97,394,16,113,63,2,2,8,6,16,270,401,24,286,59,-3,2,4,4,72,396,13,88,59,-2,2,-1,1,176,399,11,192,70,-2,2,7,0
RITES,136,631,66,362,4,71,49,2,2,4,5,5,309,358,21,314,65,2,2,7,6,69,358,11,74,47,2,2,4,3,182,360,20,187,65,-3,2,2,5
DLF,137,631,85,74,15,88,63,2,2,0,3,3,321,71,23,324,65,2,2,9,6,28,79,11,31,25,-3,-2,-4,1,194,73,24,197,66,-3,2,4,4
NMDC,138,629,97,299,16,106,63,2,2,8,6,9,243,311,19,252,44,2,2,9,5,92,297,21,101,61,2,2,1,5,188,299,21,197,69,-3,2,5,0
MARUTI,139,629,79,68,20,151,56,-2,2,-2,5,72,294,68,17,366,65,2,2,8,4,-14,75,-14,58,15,-3,-2,-5,-5,198,68,19,270,65,2,2,7,4
GPPL,140,628,73,75,6,73,64,-3,2,0,4,0,315,72,21,315,65,2,2,9,6,40,78,15,40,25,2,1,-4,1,200,72,18,200,65,2,2,7,6
DOMS,141,627,96,393,19,118,63,2,2,4,6,22,258,404,18,280,65,-2,2,1,2,79,394,20,101,55,-3,2,0,5,172,398,15,194,59,-2,2,8,4
CONCOR,142,626,91,269,13,100,63,2,2,5,6,9,291,268,16,300,65,2,2,7,5,51,272,-7,60,55,-3,2,-1,5,184,270,16,193,69,-3,2,4,4
UTIAMC,143,626,90,270,14,99,63,2,2,7,2,9,255,275,11,264,65,-3,2,5,5,72,270,13,81,61,-3,2,2,-3,200,267,19,209,69,-2,2,7,5
MFSL,144,623,90,202,11,105,63,2,2,6,6,15,291,203,16,306,65,2,2,7,5,39,208,-12,54,49,1,2,-2,1,188,200,13,203,70,-2,2,7,4
USHAMART,145,623,96,200,16,105,63,2,2,7,6,9,267,207,23,276,60,-3,2,3,4,75,203,7,84,61,-2,2,2,5,176,205,8,185,70,-2,2,6,4
MSUMI,146,623,91,139,13,96,63,2,2,5,6,5,273,145,13,278,65,-2,2,8,5,66,139,12,71,45,-3,3,5,4,188,144,11,193,70,2,2,5,4
FORTIS,147,622,86,73,13,92,63,2,2,3,3,6,288,74,21,294,60,2,2,8,3,62,73,18,68,47,-3,0,-3,3,180,75,19,186,69,-3,2,3,0
SJVN,148,621,80,426,6,89,62,2,2,3,5,9,330,420,26,339,65,2,2,9,6,20,434,7,29,25,-3,-2,-4,-3,182,427,19,191,65,-3,2,4,4
SOLARINDS,149,621,64,101,16,132,55,-3,0,-2,-2,68,330,98,26,398,65,2,2,9,6,-35,112,-10,33,-11,-3,-2,-6,-3,194,100,24,262,66,-3,2,4,4
GRSE,150,621,92,42,15,99,63,2,2,4,6,7,279,44,21,286,59,1,2,4,6,55,49,18,62,47,-3,0,-4,-3,188,39,14,195,70,-3,2,6,5
VIJAYA,151,620,94,168,13,109,63,2,2,8,6,15,207,188,16,222,38,2,2,7,4,96,168,15,111,63,2,2,8,6,208,168,23,223,69,-3,2,8,5
JAIBALAJI,152,619,68,401,10,75,43,2,3,6,4,7,294,397,26,301,58,2,2,4,6,66,402,18,73,43,-3,2,3,3,184,400,21,191,66,-3,2,3,3
BAJAJFINSV,153,618,94,325,15,112,63,2,2,7,5,18,246,333,8,264,65,-3,2,6,4,74,327,18,92,55,-3,2,-1,3,186,325,11,204,69,2,2,6,3
SBIN,154,617,80,427,10,84,63,2,2,0,3,4,288,426,19,292,65,-3,2,8,5,51,432,7,55,49,-3,2,-4,0,194,424,17,198,65,2,2,7,4
BOSCHLTD,155,616,59,483,14,132,50,-3,0,-2,0,73,315,483,21,388,65,2,2,9,6,-39,488,-13,34,-19,-3,4,-4,-4,208,483,24,281,65,2,2,6,5
GSPL,156,615,90,456,14,93,63,2,2,3,6,3,294,459,16,297,65,2,2,8,5,24,464,-13,27,39,-3,0,-4,5,204,455,18,207,69,2,2,7,4
IOC,157,614,73,465,5,73,63,2,2,-1,2,0,321,454,23,321,65,2,2,9,6,26,465,-5,26,41,-3,0,-4,-3,194,459,24,194,66,-3,2,4,4
TATACONSUM,158,613,45,405,-10,54,41,2,3,5,4,9,309,392,21,318,66,2,2,7,5,70,398,16,79,43,2,2,4,3,180,401,20,189,65,-3,2,2,4
BANKBARODA,159,610,70,464,3,74,63,2,2,-1,1,4,315,456,21,319,65,2,2,9,6,33,463,-7,37,41,-3,2,-4,4,188,460,18,192,65,2,2,3,4
FEDERALBNK,160,609,82,240,6,86,63,2,2,5,4,4,276,243,16,280,65,-3,2,8,4,65,238,9,69,55,-3,2,-1,3,182,238,13,186,70,-3,2,6,3
FSL,161,609,67,144,-10,70,63,2,2,5,5,3,288,143,18,291,60,2,2,8,6,61,142,13,64,49,-2,2,-2,1,190,145,18,193,69,-3,2,4,5
LTTS,162,608,89,271,16,98,61,2,2,3,5,9,288,269,18,297,66,-3,2,8,5,28,277,-7,37,39,-3,3,-1,-3,194,269,20,203,69,-2,2,4,4
RAYMOND,163,606,91,41,14,99,63,2,2,4,6,8,282,43,21,290,65,-3,2,5,4,51,50,16,59,39,-3,0,-4,3,174,47,3,182,70,2,2,6,4
GRASIM,164,603,58,196,-4,133,55,2,2,-1,4,75,294,196,19,369,66,-3,2,8,6,8,204,-7,83,29,-3,-2,-6,-3,168,196,16,243,65,-3,2,3,1
DEEPAKNTR,165,602,63,178,16,78,29,2,2,8,6,15,261,180,15,276,66,-3,2,2,5,99,167,19,114,63,2,2,8,5,164,176,7,179,67,-3,2,6,3
BPCL,166,602,45,149,-6,47,47,-2,3,1,2,2,306,140,18,308,65,2,2,9,6,55,146,-3,57,49,2,2,1,4,194,140,21,196,65,1,2,4,4
APOLLOHOSP,167,601,76,490,8,75,61,2,2,2,1,-1,297,488,21,296,66,-3,2,8,5,49,487,7,48,47,-3,0,-3,1,180,491,18,179,65,-3,2,3,5
MGL,168,601,87,241,15,82,61,2,2,2,5,-5,294,239,17,289,65,2,2,7,5,35,248,-7,30,47,-3,0,-3,1,190,239,16,185,69,2,2,3,3
LEMONTREE,169,601,63,51,-7,67,63,2,2,2,1,4,303,40,20,307,65,1,2,8,5,51,51,14,55,39,-3,1,-1,1,180,46,14,184,69,-3,2,3,5
UNOMINDA,170,600,95,10,18,107,63,2,2,4,6,12,288,11,18,300,66,-3,2,8,5,15,24,-15,27,39,-3,0,-5,-1,190,12,15,202,70,-2,2,7,3
NCC,171,598,84,143,13,85,62,2,2,0,5,1,312,138,21,313,65,2,2,9,5,7,150,-8,8,25,-3,-2,-3,-2,194,141,18,195,66,2,2,4,5
OIL,172,597,74,205,16,71,56,-2,2,-2,4,-3,327,198,26,324,64,2,2,9,6,-5,211,-7,-8,15,-3,-2,-5,-3,204,201,24,201,65,2,2,4,5
CSBBANK,173,596,84,328,14,93,55,2,2,6,5,9,270,330,16,279,59,2,2,6,5,61,332,18,70,47,-3,0,-4,3,172,331,13,181,70,-3,2,3,1
GUJGASLTD,174,595,70,303,-6,77,63,2,2,4,5,7,261,306,12,268,66,-2,2,6,3,69,304,7,76,61,-3,0,1,3,188,300,15,195,64,2,2,6,5
CENTRALBK,175,593,82,489,8,86,63,2,2,2,5,4,261,493,26,265,44,2,2,8,5,58,486,14,62,47,-3,0,-3,3,188,489,21,192,66,-3,2,3,5
HFCL,176,593,60,244,4,67,43,2,2,5,4,7,279,242,16,286,66,-3,2,6,6,71,235,16,78,41,2,2,5,5,176,240,18,183,65,-3,2,2,4
FINPIPE,177,591,89,486,18,99,61,2,2,0,6,10,303,485,19,313,65,2,2,8,5,-7,492,-12,3,15,-3,-2,-5,0,196,486,15,206,69,2,2,6,4
ASAHIINDIA,178,591,99,234,21,111,63,2,2,5,6,12,276,240,18,288,65,-3,2,6,4,20,247,-10,32,39,-3,0,-4,-2,184,235,8,196,69,2,2,6,5
ZENSARTECH,179,591,81,175,18,87,59,-3,2,0,5,6,285,175,19,291,59,2,2,8,5,37,179,4,43,31,-2,3,-3,4,182,175,18,188,69,-3,2,2,3
CYIENT,180,590,86,272,13,95,63,2,2,3,3,9,294,266,24,303,59,1,2,7,5,29,276,4,38,33,-3,-2,-3,0,172,274,16,181,69,-3,2,2,0
SHRIRAMFIN,181,589,86,398,16,87,61,2,2,-1,6,1,303,396,19,304,64,2,2,9,5,-1,405,-15,0,25,-3,-2,-6,0,200,394,21,201,69,-2,2,4,6
INDIANB,182,586,80,461,8,80,61,2,2,2,5,0,321,455,24,321,65,2,2,9,5,7,471,-8,7,25,-3,-2,-5,0,178,464,18,178,65,-3,2,3,4
JSL,183,586,34,12,-9,105,50,-3,0,-2,-2,71,330,4,26,401,65,2,2,9,6,-21,19,-15,50,9,-3,-2,-5,-5,172,8,16,243,66,-3,2,2,3
SAPPHIRE,184,585,83,138,11,99,63,-2,2,6,3,16,255,148,8,271,65,-2,2,7,5,51,141,10,67,29,2,2,7,1,180,139,7,196,69,2,2,6,4
ENGINERSIN,185,584,88,330,15,89,61,2,2,2,6,1,303,325,19,304,64,2,2,8,6,4,339,-8,5,25,-3,-2,-5,-3,188,328,19,189,70,-3,2,2,4
IDFC,186,583,70,397,17,90,35,2,2,8,6,20,261,403,21,281,59,-3,2,4,4,88,390,21,108,61,-2,2,1,5,144,405,13,164,54,-2,3,6,-2
RRKABEL,187,583,93,103,14,111,63,2,2,7,5,18,243,114,13,261,65,-2,2,1,2,75,103,7,93,61,2,2,2,1,154,112,9,172,60,-2,2,8,0
BORORENEW,188,580,74,18,4,78,57,2,2,4,5,4,243,17,13,247,65,-3,2,4,0,71,14,9,75,55,2,2,-1,4,188,14,11,192,69,2,2,5,5
"J&KBANK",189,579,65,363,-7,69,63,2,2,2,3,4,306,360,24,310,59,2,2,9,6,28,366,-4,32,41,-3,0,-4,-2,176,363,18,180,66,-3,2,3,2
OFSS,190,579,31,300,-10,99,48,-3,0,-2,-2,68,315,292,21,383,65,2,2,9,6,-41,309,-14,27,-19,-3,1,-1,-5,206,293,26,274,65,2,2,2,6
COLPAL,191,577,42,233,-4,117,47,-3,0,-1,3,75,303,229,23,378,59,2,2,9,6,-29,245,-11,46,-19,2,3,-1,-3,186,230,23,261,65,-3,2,2,4
ENDURANCE,192,576,82,273,10,88,61,2,2,2,5,6,270,272,19,276,59,1,2,5,4,46,274,18,52,39,-3,0,-4,-4,172,275,16,178,70,-3,2,1,0
GMDCLTD,193,575,57,334,14,66,29,2,2,5,5,9,282,328,21,291,59,2,2,4,6,61,331,18,70,39,-3,2,0,5,166,332,11,175,68,-3,3,3,1
SPARC,194,575,76,274,12,88,57,2,2,-1,4,12,300,265,17,312,65,2,2,8,6,-11,281,-20,1,15,-3,1,-5,1,198,266,19,210,69,2,2,3,4
CIEINDIA,195,575,87,72,15,99,55,2,2,8,5,12,252,81,20,264,59,-3,2,3,3,88,70,15,100,61,-2,2,7,5,136,79,10,148,53,-2,3,6,-2
AVANTIFEED,196,575,80,46,3,84,63,2,2,4,6,4,255,51,10,259,59,2,2,6,6,46,52,13,50,39,-3,0,-4,1,190,40,18,194,65,2,2,2,6
SANOFI,197,574,54,79,14,52,29,2,2,2,5,-2,282,76,19,280,59,2,2,6,6,58,76,15,56,47,-3,2,-3,0,182,76,15,180,70,-2,3,2,3
"L&TFH",198,574,87,43,11,91,63,2,2,3,6,4,276,45,16,280,59,2,2,7,6,25,55,-10,29,41,-3,0,-4,1,182,43,18,186,69,-3,2,2,3
IRFC,199,573,63,431,-6,60,61,2,2,2,2,-3,309,423,28,306,58,2,2,8,5,18,436,16,15,15,-3,-2,-5,-3,186,429,21,183,65,-3,2,4,4
ZYDUSLIFE,200,571,32,485,-10,100,48,-3,0,-4,1,68,315,484,23,383,64,2,2,9,5,-46,490,-11,22,-19,-3,-2,-6,-5,202,484,24,270,65,2,2,3,5
INDUSTOWER,201,570,100,263,19,152,63,2,2,8,6,52,153,281,16,205,17,2,2,8,6,89,262,21,141,61,-2,2,4,3,176,264,21,228,49,2,2,9,5
OBEROIRLTY,202,569,78,49,13,81,59,1,2,-1,4,3,306,39,21,309,65,1,2,8,5,-6,57,-9,-3,15,-3,-2,-4,-3,188,42,18,191,69,-2,2,3,4
RVNL,203,567,62,404,-7,60,61,1,2,1,4,-2,291,400,26,289,58,2,2,4,5,30,403,-5,28,31,-3,4,2,1,186,402,21,184,66,-3,2,3,4
PIIND,204,566,78,460,14,84,59,-3,2,0,6,6,273,462,16,279,66,-3,2,7,3,15,467,13,21,15,-3,-2,-5,-3,194,456,12,200,69,2,2,7,5
ESCORTS,205,566,89,237,18,98,55,2,2,6,6,9,258,247,20,267,59,-3,2,4,4,60,239,13,69,49,-3,0,-2,3,150,246,12,159,54,-3,3,6,3
TCS,206,563,48,468,-6,53,41,2,3,5,3,5,282,461,18,287,65,2,2,6,1,58,458,10,63,35,2,2,6,3,170,465,14,175,66,-3,2,2,4
ACI,207,563,46,52,7,56,23,2,3,6,5,10,264,48,15,274,65,-2,2,5,3,83,38,21,93,43,2,2,9,6,160,49,12,170,59,-2,2,5,4
IOB,208,562,77,463,8,78,61,2,2,-1,5,1,267,466,26,268,45,2,2,8,6,19,468,16,20,15,-3,-2,-5,-2,198,457,24,199,65,-2,2,4,6
HINDPETRO,209,562,45,310,4,47,33,2,3,2,1,2,303,299,19,305,65,2,2,8,5,34,307,15,36,9,2,2,2,4,178,304,20,180,64,-3,2,3,3
RELIANCE,210,561,66,306,10,66,57,-2,2,-1,0,0,291,301,16,291,65,2,2,8,4,12,310,-6,12,29,-3,0,-5,-3,192,302,19,192,65,2,2,3,5
ADANIENT,211,560,60,466,-8,60,61,2,2,-1,4,0,270,465,16,270,66,-3,2,4,5,42,460,-4,42,49,-3,0,-4,4,188,462,16,188,65,2,2,6,3
WELSPUNLIV,212,560,75,304,4,76,61,2,2,1,5,1,276,303,16,277,60,2,2,6,6,34,308,18,35,25,-3,-2,-5,1,174,306,14,175,69,-3,3,1,3
GLS,213,559,86,16,10,84,63,2,2,3,6,-2,219,22,20,217,38,2,2,6,5,70,16,14,68,55,-3,0,1,3,186,15,20,184,65,-2,2,3,5
FLUOROCHEM,214,557,50,112,18,60,15,2,2,8,5,10,252,113,13,262,66,-3,2,2,4,83,102,21,93,43,2,2,9,6,162,113,6,172,67,-2,3,6,1
GMRINFRA,215,556,68,243,-3,69,61,2,2,1,5,1,303,234,24,304,59,2,2,8,6,2,251,-10,3,25,-3,-2,-5,-3,182,241,20,183,66,-3,2,3,3
BIRLACORPN,216,556,43,246,10,47,23,2,2,4,2,4,282,241,19,286,59,2,2,6,6,49,242,13,53,39,-2,2,-1,-2,178,242,18,182,65,-3,3,2,4
SONACOMS,217,556,77,177,11,80,59,-3,1,5,4,3,255,184,10,258,59,2,2,6,6,65,178,16,68,35,2,2,6,4,156,180,7,159,65,1,2,2,1
JSWSTEEL,218,555,80,107,9,92,63,2,2,3,1,12,273,109,18,285,66,-3,2,7,1,20,113,-7,32,39,-3,-2,-5,-2,170,108,7,182,69,-2,2,6,3
SYNGENE,219,552,70,399,17,85,35,2,2,8,6,15,246,407,16,261,59,-2,2,2,5,91,391,19,106,63,2,2,0,5,130,407,6,145,45,2,3,6,3
UCOBANK,220,551,73,276,4,74,61,2,2,-1,5,1,261,276,26,262,44,2,2,8,5,26,278,14,27,25,-3,-2,-5,-3,190,271,21,191,66,-2,2,3,5
AIAENG,221,550,77,275,13,74,57,2,2,-2,5,-3,297,271,24,294,59,2,2,7,5,-7,282,-12,-10,15,-3,-2,-4,-1,186,272,21,183,70,-2,2,2,0
SUZLON,222,548,57,430,7,61,37,2,2,4,5,4,246,437,26,250,38,2,2,8,6,57,431,8,61,49,-2,2,-4,4,184,428,20,188,70,-3,3,2,0
APLLTD,223,547,58,493,10,55,43,2,2,-4,5,-3,294,490,15,291,65,2,2,8,6,12,491,-7,9,21,-2,1,-1,0,186,490,21,183,65,-2,2,1,6
EQUITASBNK,224,547,56,428,11,66,29,2,2,7,5,10,261,432,20,271,59,-3,2,4,5,62,428,16,72,41,-2,2,0,5,158,433,13,168,68,-3,1,2,-2
IRCON,225,546,57,467,-7,54,57,2,2,-2,5,-3,309,458,26,306,59,2,2,9,5,-1,472,-3,-4,15,-3,-2,-6,-2,184,463,20,181,66,-3,2,3,4
SUPREMEIND,226,546,72,277,13,72,53,1,2,-1,4,0,270,274,20,270,59,1,2,2,6,38,275,-10,38,45,-2,3,5,-3,166,276,14,166,70,-3,2,-1,1
GSFC,227,545,57,335,16,65,29,2,2,3,5,8,255,336,19,263,59,-3,2,3,5,59,333,16,67,47,-3,0,-4,3,166,333,15,174,67,-3,3,1,0
NH,228,544,65,210,8,56,57,2,2,-2,-2,-9,300,205,24,291,59,2,2,7,6,0,212,-3,-9,15,-3,-2,-5,-2,188,208,20,179,69,-3,2,2,4
MANKIND,229,543,81,396,11,99,61,2,2,-1,6,18,264,402,20,282,65,-2,2,1,2,0,404,-12,18,25,-3,-2,-5,-3,180,396,14,198,59,2,2,8,5
MINDACORP,230,541,74,491,13,71,57,2,2,-2,2,-3,306,486,24,303,59,2,2,9,6,-6,494,-7,-9,15,-3,-2,-4,-5,170,493,16,167,65,-3,2,0,5
KPRMILL,231,540,80,204,16,86,61,-3,2,2,2,6,261,208,20,267,59,-3,2,4,5,3,210,-12,9,9,2,3,0,1,190,203,18,196,70,-3,2,5,3
CARBORUNIV,232,539,80,488,16,87,55,2,2,0,5,7,267,492,16,274,66,-3,2,4,4,-11,493,-10,-4,9,-3,-2,-6,1,196,487,15,203,69,2,2,6,4
LT,233,539,59,209,13,59,49,-3,2,-2,0,0,312,200,26,312,59,2,2,9,6,-16,214,-9,-16,9,-3,-2,-6,-5,184,206,20,184,69,-3,2,3,1
POWERGRID,234,537,55,147,10,52,41,2,2,-4,4,-3,318,136,21,315,66,2,2,9,6,-13,152,-13,-16,15,-3,-2,-5,-5,180,148,20,177,65,-3,2,2,4
BANKINDIA,235,537,78,48,3,82,63,2,2,3,5,4,249,55,21,253,44,2,2,8,6,26,54,12,30,25,-3,-2,-4,-2,180,44,18,184,65,-2,2,3,4
ASHOKLEY,236,537,87,13,15,98,55,2,2,7,6,11,225,20,14,236,59,-3,2,3,0,78,11,14,89,61,-2,2,0,3,136,19,6,147,55,-2,3,6,0
IDFCFIRSTB,237,536,60,305,17,74,29,2,2,7,3,14,252,308,18,266,60,-3,2,3,4,94,296,19,108,63,2,2,2,6,116,312,10,130,43,-2,1,5,1
MAHABANK,238,532,82,359,13,83,62,2,2,-1,4,1,258,366,23,259,45,2,2,9,5,-1,369,-6,0,15,-3,-2,-5,0,192,358,21,193,66,-2,2,4,5
MRPL,239,532,47,311,4,44,50,-3,0,-4,0,-3,330,294,26,327,65,2,2,9,6,-36,314,-13,-39,-11,-3,-2,-5,-2,194,303,24,191,65,-2,2,2,6
JKCEMENT,240,532,66,207,-5,67,61,2,2,1,5,1,297,204,18,298,66,1,2,7,5,-12,213,-13,-11,15,-3,-2,-4,-5,180,207,19,181,65,-3,2,3,4
IDBI,241,531,81,332,10,82,61,2,2,2,4,1,249,338,21,250,45,2,2,8,5,18,338,-12,19,39,-3,0,-3,-3,182,330,18,183,65,-2,2,3,5
COROMANDEL,242,531,87,268,16,102,55,2,2,6,6,15,240,277,14,255,59,-2,2,3,4,63,271,16,78,49,-3,0,-2,3,126,278,6,141,53,-2,3,6,-3
CHAMBLFERT,243,528,90,238,15,93,63,2,2,3,5,3,255,248,10,258,65,-3,2,7,4,20,250,-12,23,39,-3,0,-5,1,160,245,9,163,69,-2,2,3,-1
NATCOPHARM,244,527,63,145,13,61,49,-3,0,-1,5,-2,276,147,17,274,59,2,2,7,5,4,151,16,2,-13,-2,4,3,-4,186,146,16,184,65,2,2,3,5
BAYERCROP,245,527,33,116,13,34,5,2,2,5,6,1,252,117,11,253,59,2,2,5,5,69,108,13,70,41,2,2,6,5,172,111,13,173,67,-3,3,1,5
SHYAMMETL,246,525,44,151,4,37,29,2,2,2,5,-7,282,146,19,275,59,2,2,7,5,40,147,15,33,27,-3,0,-3,4,166,149,13,159,63,-3,3,2,5
ADANIGREEN,247,524,61,21,4,58,57,-3,2,-2,3,-3,270,13,15,267,65,-3,2,6,5,12,25,9,9,15,-3,-2,-3,-4,184,16,18,181,65,-3,2,4,6
ONGC,248,523,35,371,-6,32,41,2,2,-4,0,-3,315,359,21,312,65,2,2,9,6,-14,371,-11,-17,9,-3,-2,-4,-3,190,359,24,187,65,-3,2,2,5
SAREGAMA,249,523,85,44,13,87,63,2,2,2,3,2,252,54,14,254,66,-3,2,1,4,42,53,14,44,39,-3,0,-4,-4,142,51,3,144,59,-2,2,4,5
BHARATFORG,250,518,45,369,3,49,29,2,2,4,5,4,255,367,16,259,60,-3,2,7,3,38,364,7,42,29,2,2,-2,0,176,361,16,180,68,-3,3,1,3
ICICIGI,251,518,39,340,-5,36,49,-3,2,-4,0,-3,291,329,15,288,65,2,2,8,5,-7,344,-10,-10,15,-3,-2,-5,-2,198,326,23,195,65,2,2,2,5
AMBUJACEM,252,518,48,248,-3,42,49,-3,2,-2,5,-6,306,237,19,300,65,2,2,8,6,-18,252,-16,-24,15,-3,-2,-7,-5,188,243,18,182,65,2,2,2,5
LAURUSLABS,253,517,93,104,17,105,63,2,2,4,5,12,207,121,8,219,52,-3,3,5,4,17,114,-13,29,39,-3,0,-4,-2,188,105,10,200,69,2,2,7,4
HAVELLS,254,513,69,110,13,66,55,-3,0,-1,5,-3,273,112,15,270,65,-3,2,7,5,-20,117,-10,-23,-1,-3,1,-4,-3,194,106,18,191,65,2,2,5,5
PRESTIGE,255,512,52,368,9,49,41,2,2,-2,0,-3,303,361,24,300,59,2,2,9,5,-14,372,-11,-17,9,-3,-2,-6,-1,174,365,18,171,70,-3,2,0,0
AMBER,256,511,60,429,-5,62,55,2,2,1,5,2,276,429,19,278,59,2,2,6,4,1,437,-3,3,15,-3,1,-5,-4,172,431,15,174,69,-3,2,2,1
JWL,257,511,71,77,7,65,57,2,2,-2,5,-6,282,79,24,276,59,1,2,4,4,-16,81,-12,-22,9,-3,-2,-6,-2,180,77,16,174,70,-3,2,2,3
AUROPHARMA,258,509,70,403,13,64,55,2,2,-2,0,-6,282,406,19,276,59,2,2,7,5,-13,407,-14,-19,15,-3,-2,-7,-2,176,404,18,170,69,-3,2,2,0
METROPOLIS,259,509,97,133,16,142,63,2,2,8,6,45,123,158,3,168,25,2,3,6,2,96,133,23,141,63,2,2,2,4,148,143,14,193,49,-2,2,7,4
MOTHERSON,260,508,88,327,13,93,63,2,2,5,3,5,174,345,13,179,31,2,2,7,3,83,329,13,88,61,2,2,2,3,158,336,16,163,45,2,2,8,6
INDUSINDBK,261,503,83,17,6,83,63,2,2,5,5,0,252,16,14,252,59,-3,2,7,5,34,23,-7,34,47,-3,0,-3,0,134,21,-5,134,70,-3,2,2,1
JUBLPHARMA,262,501,93,295,16,139,63,2,2,4,6,46,171,312,9,217,31,2,2,7,6,31,303,-12,77,47,-3,0,-2,1,160,297,19,206,49,-2,2,8,4
FINCABLES,263,501,68,206,19,68,35,2,2,5,5,0,249,212,18,249,59,-3,2,3,4,60,207,-4,60,59,-2,0,4,3,124,212,12,124,44,-3,1,5,3
ELECON,264,496,66,307,7,63,49,2,2,1,5,-3,270,307,24,267,59,-3,2,4,4,-13,312,-14,-16,15,-3,-2,-4,-5,176,307,14,173,69,-3,3,1,4
BIKAJI,265,496,58,146,18,59,29,2,2,3,4,1,261,151,13,262,65,-2,2,3,6,28,148,-13,29,41,-3,2,-4,5,148,150,13,149,58,-3,3,3,0
PFC,266,492,39,150,-3,43,37,2,2,0,1,4,306,139,26,310,59,2,2,8,5,-31,153,-9,-27,-9,-3,-2,-5,-3,174,147,23,178,64,-3,2,0,1
SBILIFE,267,491,62,366,6,60,61,-3,2,-1,-3,-2,252,370,14,250,59,-3,2,7,5,15,367,-5,13,29,-3,0,-3,-3,164,366,14,162,66,-3,2,0,3
SAFARI,268,491,58,364,15,62,29,2,2,5,5,4,273,363,23,277,60,-3,2,4,5,68,360,21,72,49,-3,2,-4,3,88,372,-10,92,54,-3,1,1,1
CHENNPETRO,269,491,39,117,-3,33,41,1,0,-4,4,-6,312,105,26,306,59,2,2,9,6,-32,121,-8,-38,-11,-3,-2,-6,-2,178,114,20,172,63,-3,2,2,5
DIVISLAB,270,486,87,301,17,97,55,2,2,6,5,10,186,315,3,196,52,-3,2,4,4,67,302,16,77,55,-3,2,-1,-2,136,308,5,146,53,-2,3,6,3
POLICYBZR,271,486,92,7,19,138,63,2,2,1,5,46,123,24,17,169,11,-2,2,7,6,49,9,18,95,39,-3,0,-2,-3,176,9,21,222,49,2,2,9,5
MMTC,272,484,81,14,13,85,57,2,2,2,5,4,150,25,21,154,13,2,2,6,6,53,17,14,57,47,-3,0,-3,-2,196,13,21,200,70,-3,2,2,6
CHOLAFIN,273,482,81,458,16,87,53,2,2,2,6,6,258,467,21,264,59,-3,2,4,3,3,469,-10,9,25,-3,-2,-4,-3,134,469,12,140,54,-2,3,4,-4
SIGNATURE,274,481,45,338,-10,42,50,2,2,-3,4,-3,267,335,22,264,64,-2,2,1,2,2,342,-13,-1,29,-3,-2,-4,-5,170,335,24,167,55,-2,2,2,4
KFINTECH,275,480,66,76,10,68,51,2,2,-4,5,2,273,80,19,275,65,-2,2,4,3,-5,80,-7,-3,15,-3,-2,-5,-3,144,80,18,146,53,-3,2,0,2
IGL,276,477,93,357,16,112,63,2,2,4,6,19,246,365,3,265,66,2,2,6,3,29,363,-10,48,47,-3,0,-2,-3,90,371,6,109,25,2,2,6,4
APOLLOTYRE,277,476,-4,250,-13,-1,-3,2,3,4,3,3,276,244,21,279,59,1,2,4,5,49,244,16,52,19,2,2,6,4,152,248,16,155,59,-3,0,1,3
CGPOWER,278,475,55,367,14,59,47,-3,0,-4,1,4,276,362,24,280,60,-3,2,4,5,-36,375,-10,-32,-19,2,1,-7,-3,176,362,16,180,65,2,2,0,3
TATACOMM,279,475,35,81,-5,42,41,-3,0,-2,4,7,288,73,21,295,60,2,2,7,4,-35,82,-16,-28,-11,-3,1,-1,-5,180,74,16,187,65,2,2,0,5
ASTRAZEN,280,473,18,280,11,17,-3,2,3,2,3,-1,273,273,21,272,59,2,2,1,6,27,279,20,26,7,-3,0,-2,5,156,277,15,155,61,-3,3,1,1
POLYMED,281,473,48,181,-6,47,51,2,2,-1,0,-1,273,181,19,272,59,-2,2,7,6,-9,182,-9,-10,9,-2,-2,-3,-2,162,179,16,161,63,-3,2,0,3
WESTLIFE,282,471,48,113,16,58,15,2,2,7,6,10,246,115,16,256,60,-3,2,2,5,95,100,16,105,63,2,2,7,5,72,123,-10,82,37,-2,3,5,3
QUESS,283,471,103,37,21,148,63,2,2,9,6,45,51,57,6,96,-4,2,3,6,4,106,36,26,151,63,2,2,8,5,166,37,17,211,48,2,2,9,5
AXISBANK,284,470,39,247,4,42,29,2,2,2,0,3,243,249,14,246,59,-3,2,6,3,23,249,14,26,19,-3,0,-4,-3,162,244,11,165,68,-3,3,1,1
TANLA,285,470,43,22,17,52,9,2,2,7,6,9,234,19,13,243,60,-3,2,1,5,70,13,19,79,41,2,2,1,5,114,23,12,123,37,-2,1,5,4
CANFINHOME,286,467,80,360,16,81,57,2,2,-2,5,1,246,371,17,247,59,-3,2,6,1,-10,370,-15,-9,15,-3,-2,-4,-1,150,368,6,151,68,-2,2,1,0
RCF,287,467,56,20,14,60,29,2,2,3,6,4,252,14,18,256,59,-3,2,2,6,39,22,16,43,27,-3,0,-4,3,116,24,-10,120,68,-3,1,1,1
CELLO,288,465,53,111,8,62,29,2,2,7,5,9,168,123,-11,177,65,-2,2,0,2,87,101,13,96,63,-3,2,6,6,148,115,8,157,57,-2,1,6,4
PRSMJOHNSN,289,464,60,180,16,55,41,1,0,-4,6,-5,282,178,18,277,59,2,2,7,6,-51,186,-15,-56,-25,-3,1,-8,-1,178,177,18,173,67,-3,2,0,5
CRISIL,290,462,30,313,16,24,25,-3,-2,-3,-3,-6,312,298,21,306,66,2,2,7,6,-60,317,-7,-66,-43,2,-2,-6,-4,186,305,20,180,63,2,2,1,5
BAJFINANCE,291,462,76,302,16,82,43,2,2,7,6,6,207,313,9,213,59,-3,2,2,0,71,301,11,77,59,2,2,-1,-2,102,314,6,108,37,2,3,5,-2
LLOYDSME,292,459,98,453,17,133,63,2,2,8,6,35,51,477,16,86,-3,-2,3,1,2,99,452,24,134,63,2,2,2,6,176,454,13,211,59,2,2,8,4
OLECTRA,293,457,53,80,10,47,43,2,0,-4,2,-6,285,78,23,279,59,-3,2,8,6,-55,88,-8,-61,-35,-3,-2,-5,-2,180,78,21,174,64,-3,2,1,5
ITC,294,457,40,54,15,40,15,2,2,5,1,0,258,52,23,258,60,-3,2,1,3,75,44,16,75,61,-3,2,-1,0,84,54,10,84,29,-2,4,0,1
UJJIVANSFB,295,454,59,179,18,60,29,2,2,3,5,1,219,189,18,220,39,2,2,6,6,33,181,-10,34,47,-3,3,-3,-1,142,184,15,143,54,-3,1,1,3
GNFC,296,451,69,462,18,78,35,2,2,6,6,9,207,471,6,216,60,-3,2,2,2,30,461,-10,39,49,-3,0,-4,-2,136,468,12,145,53,-3,0,6,0
LICI,297,448,80,333,13,81,61,2,2,1,1,1,186,343,14,187,36,-2,2,6,6,-3,343,-8,-2,15,-3,1,-4,-4,184,329,21,185,65,-3,2,3,4
SUNPHARMA,298,446,23,281,-9,13,39,-3,0,-4,0,-10,312,267,23,302,65,2,2,7,5,-71,287,-14,-81,-43,-3,-2,-6,-3,192,273,23,182,63,2,2,1,5
DCMSHRIRAM,299,445,35,433,13,42,9,2,2,5,4,7,240,438,16,247,59,-3,2,1,5,59,429,20,66,35,-3,2,-1,6,104,438,13,111,37,-3,1,4,0
TORNTPHARM,300,442,17,435,-6,17,25,-2,-2,-3,5,0,294,425,21,294,60,2,2,9,4,-47,441,-5,-47,-43,2,1,-3,1,178,430,20,178,63,-3,2,2,5
VBL,301,441,25,409,-6,19,39,-3,0,-5,0,-6,312,394,26,306,59,2,2,9,6,-72,410,-13,-78,-43,-3,-2,-6,-5,182,403,24,176,64,-3,2,1,3
UNIONBANK,302,440,49,432,11,43,41,-3,0,-4,4,-6,261,435,24,255,44,2,2,9,6,-42,442,-10,-48,-19,-3,-2,-5,-3,178,432,20,172,64,-2,2,1,4
TEJASNET,303,439,43,309,16,49,15,2,2,3,5,6,249,310,18,255,59,-3,2,2,5,31,306,-12,37,47,-3,0,-2,1,110,313,11,116,37,-2,4,5,0
SWANENERGY,304,439,42,115,-3,41,43,2,2,-4,2,-1,309,104,21,308,65,2,2,7,6,-23,118,-9,-24,-9,-3,-2,-4,4,112,120,-12,111,63,-3,2,1,5
RAILTEL,305,433,11,496,-7,12,13,1,3,-4,5,1,297,487,23,298,59,2,2,7,6,-50,498,-7,-49,-29,-3,-2,-6,-3,174,492,20,175,64,-3,2,0,4
HBLPOWER,306,432,21,183,-10,18,27,2,2,-4,4,-3,300,173,26,297,59,2,2,5,6,-36,185,-12,-39,-9,-3,-2,-5,-5,150,182,16,147,59,-3,0,0,3
APLAPOLLO,307,431,50,336,-3,51,55,-3,2,-1,0,1,258,337,21,259,59,-3,2,3,4,0,341,-3,1,15,-3,-2,-4,-3,122,343,4,123,55,-3,3,4,-2
MAHSEAMLES,308,428,-3,184,4,1,-15,2,3,0,3,4,291,174,24,295,59,2,2,4,6,-28,183,7,-24,-29,-3,-2,-5,4,164,178,20,168,62,-3,3,0,0
SKFINDIA,309,424,40,245,16,50,9,2,2,8,3,10,228,250,16,238,60,-3,0,2,1,82,234,17,92,61,2,2,0,0,64,250,4,74,17,2,4,5,0
ROUTE,310,422,36,341,-10,31,49,2,2,-2,-5,-5,237,341,11,232,59,-3,2,6,4,-12,345,-16,-17,1,-2,1,3,1,166,337,16,161,69,-3,2,1,-2
CREDITACC,311,422,47,53,15,52,19,2,2,4,5,5,252,53,16,257,59,2,2,1,4,72,42,17,77,43,2,2,5,3,46,58,-10,51,36,-3,1,-1,0
HDFCAMC,312,411,9,122,-8,4,25,-3,-2,-3,0,-5,288,110,19,283,59,2,2,8,6,-61,124,-9,-66,-43,-2,-2,-6,1,180,109,23,175,63,-3,2,1,4
ISEC,313,410,-1,441,4,-4,-11,2,4,2,-2,-3,264,434,16,261,59,2,2,4,5,18,435,13,15,-9,2,2,6,4,132,436,21,129,51,-3,0,-1,-2
CRAFTSMAN,314,408,45,78,16,54,15,2,2,5,5,9,228,86,16,237,57,-3,2,1,3,74,72,9,83,61,2,2,2,-2,52,88,-11,61,39,-3,1,0,0
SUNTV,315,407,42,148,10,48,19,2,2,4,5,6,252,153,13,258,59,1,2,3,6,57,143,16,63,35,1,2,-2,5,50,155,-13,56,44,-3,1,-1,-3
AJANTPHARM,316,404,36,471,11,30,29,-3,0,-5,4,-6,282,463,18,276,59,2,2,7,6,-62,477,-13,-68,-43,1,1,-6,-2,154,467,18,148,59,-3,2,0,1
PCBL,317,404,9,185,-6,0,5,2,2,0,6,-9,291,177,21,282,59,2,2,7,6,-49,187,-8,-58,-29,-3,-2,-5,-2,162,181,13,153,64,-3,3,-1,5
PERSISTENT,318,399,3,251,-15,-3,13,2,4,-2,1,-6,282,245,24,276,59,-3,2,7,5,-36,254,-9,-42,-31,2,2,2,-2,156,249,21,150,59,-3,0,0,1
TVSMOTOR,319,398,0,252,-6,-6,15,-3,-2,-5,1,-6,309,235,26,303,59,2,2,8,6,-67,256,-11,-73,-43,-3,-2,-5,-3,162,247,23,156,59,-3,2,0,0
GODREJCP,320,393,14,436,6,11,15,-2,1,-4,-2,-3,288,427,16,285,65,2,2,7,4,-60,444,-5,-63,-43,-3,-2,-4,-3,154,434,16,151,59,-3,2,0,3
FIVESTAR,321,390,70,492,14,68,53,2,2,2,-3,-2,264,494,18,262,65,-2,2,4,1,-12,496,-15,-14,9,-3,1,-3,-1,70,496,-8,68,43,-2,3,1,-2
TRIDENT,322,390,26,212,10,24,9,2,2,2,1,-2,237,213,13,235,60,-3,2,2,5,-17,215,13,-19,-19,-3,-2,-4,-2,146,210,13,144,55,-3,3,1,4
ECLERX,323,388,10,347,4,11,-1,2,2,-1,4,1,264,332,18,265,59,-3,2,7,5,-47,347,-5,-46,-29,-3,-2,-4,-4,160,338,16,161,61,-3,3,-1,4
TITAGARH,324,388,16,217,4,13,5,2,2,1,2,-3,264,211,24,261,57,-3,2,2,6,-57,217,-12,-60,-29,-3,-2,-6,-5,168,209,18,165,62,-3,3,1,3
PNBHOUSING,325,386,70,109,19,79,35,2,2,6,6,9,105,125,15,114,6,2,2,6,4,62,106,18,71,49,-3,0,-2,0,140,116,13,149,54,-3,1,2,3
JSWINFRA,326,382,29,24,-7,26,39,-3,0,-4,4,-3,249,18,18,246,65,-2,2,1,-1,-35,27,-8,-38,-19,-3,4,-6,-3,142,20,13,139,53,-2,2,1,4
NESTLEIND,327,377,9,346,-3,12,15,-3,1,-1,0,3,261,334,18,264,59,2,2,1,5,-36,346,7,-33,-49,2,2,2,0,140,340,14,143,60,-3,2,-1,-2
ULTRACEMCO,328,373,26,374,4,14,25,2,0,-5,0,-12,270,368,17,258,60,1,2,5,5,-61,381,-9,-73,-35,-3,-2,-7,-5,150,370,18,138,60,-3,0,-1,1
INTELLECT,329,372,2,376,-8,-13,15,-3,-2,-4,4,-15,285,364,19,270,59,2,2,7,6,-66,383,-16,-81,-43,-3,1,-5,0,166,369,20,151,60,-3,2,-1,5
CUB,330,372,99,265,19,114,63,2,2,7,6,15,87,284,3,102,17,-2,3,5,3,73,266,20,88,55,-3,0,-2,3,98,280,6,113,31,2,2,7,1
MHRIL,331,371,23,153,-9,20,33,2,0,-4,1,-3,267,150,21,264,59,-3,2,4,6,-52,156,-7,-55,-35,-3,1,-5,-3,136,152,11,133,54,-3,3,-1,4
BALKRISIND,332,368,12,344,13,18,-9,2,2,3,1,6,231,339,14,237,59,-3,2,1,4,33,335,-5,39,47,-3,0,-4,-2,86,345,8,92,33,-2,4,0,0
BLS,333,367,-19,187,-11,-23,-15,2,3,-1,3,-4,270,183,24,266,59,-3,2,4,4,-28,184,10,-32,-29,-3,1,-5,-2,148,183,15,144,60,-3,0,-1,3
JBMA,334,366,-23,124,-8,-38,-9,-2,4,-5,-3,-15,297,111,26,282,59,2,2,4,6,-47,123,3,-62,-55,2,3,0,0,154,119,21,139,60,-3,0,-2,1
CHOLAHLDNG,335,363,21,118,-3,17,31,-3,0,-2,-2,-4,258,116,19,254,59,2,2,1,3,-62,125,-13,-66,-35,-3,1,-7,-5,150,117,14,146,60,-3,2,-1,3
ACC,336,358,-3,60,-12,-15,15,-3,-2,-5,4,-12,288,47,16,276,65,2,2,6,5,-75,63,-16,-87,-43,-3,-2,-6,-5,160,50,16,148,59,-2,2,0,5
HEROMOTOCO,337,356,-5,186,-7,-20,15,-3,-2,-5,-3,-15,285,182,19,270,59,2,2,7,6,-67,190,-10,-82,-43,-3,-2,-7,-2,158,185,21,143,59,-3,2,-1,1
RECLTD,338,355,-9,349,-8,-19,9,-3,-2,-5,0,-10,306,326,26,296,59,2,2,8,5,-94,352,-16,-104,-63,-3,-2,-6,-4,162,339,21,152,60,-3,2,0,1
GESHIP,339,354,20,119,-4,10,29,-3,0,-5,3,-10,261,118,20,251,59,-3,2,5,4,-67,128,-9,-77,-43,-3,-2,-6,-4,150,118,18,140,59,-3,2,-2,1
CEATLTD,340,352,3,315,-6,-3,11,2,1,-5,0,-6,294,302,24,288,59,2,2,6,5,-89,320,-12,-95,-63,-3,-2,-5,-4,150,309,16,144,59,-3,0,-1,4
RBLBANK,341,344,59,365,15,62,29,2,2,6,5,3,39,378,14,42,-15,2,2,5,5,69,359,16,72,55,-3,0,-2,3,174,364,14,177,68,-3,3,1,4
CIPLA,342,343,-6,62,-10,-21,15,-3,-2,-4,-2,-15,282,50,19,267,59,2,2,7,5,-72,62,-16,-87,-43,-3,1,-6,-5,154,52,16,139,59,-3,2,-1,4
KOTAKBANK,343,341,58,242,10,69,35,2,2,6,3,11,168,252,6,179,50,-3,1,1,1,82,233,16,93,61,2,2,0,1,22,251,-7,33,11,2,3,5,-3
TITAN,344,341,18,27,-4,8,29,-2,0,-5,0,-10,264,15,21,254,59,-3,2,4,5,-73,30,-14,-83,-43,-3,-2,-6,-5,142,22,14,132,59,-3,2,-2,1
BSOFT,345,340,-24,89,-11,-33,-9,2,-2,-4,0,-9,291,75,21,282,59,2,2,7,6,-72,93,-9,-81,-63,2,1,-6,3,154,81,20,145,60,-3,0,-1,1
ABBOTINDIA,346,339,-6,28,-10,-6,9,-2,1,-4,0,0,270,12,21,270,60,1,2,3,3,-73,28,-9,-73,-63,1,-2,-5,5,148,17,18,148,59,-3,2,-2,0
FACT,347,337,-13,316,-6,-18,-15,2,3,-1,4,-5,270,309,21,265,59,1,2,1,6,-51,315,-10,-56,-29,-3,-2,-5,-2,136,311,13,131,56,-3,1,-3,4
EASEMYTRIP,348,337,-25,91,-9,-34,-15,2,3,-4,-2,-9,273,82,21,264,66,-3,2,2,3,-24,84,14,-33,-29,-3,1,-4,-3,122,84,13,113,43,2,0,-1,4
GILLETTE,349,336,5,410,-3,-5,15,-2,-2,-3,0,-10,267,408,16,257,58,2,2,6,5,-70,411,-11,-80,-43,-3,-2,-6,-5,144,409,20,134,54,-3,0,-2,3
BBTC,350,333,-10,377,-4,-16,-9,2,1,-3,3,-6,264,369,13,258,59,2,2,6,6,-73,382,-8,-79,-61,-3,1,-1,-1,158,367,18,152,59,-3,0,0,5
TRIVENI,351,329,29,407,3,30,17,2,2,2,3,1,249,410,18,250,59,-3,2,2,5,-18,406,-10,-17,-5,-3,0,-3,3,68,412,4,69,29,-3,1,-1,4
BAJAJHLDNG,352,328,-21,86,-10,-27,-9,-2,4,-4,0,-6,258,83,24,252,59,-3,2,1,3,-43,86,8,-49,-55,2,3,2,-3,140,83,16,134,59,-3,0,-2,0
KPITTECH,353,325,-18,475,-10,-30,-15,2,2,-1,4,-12,276,468,24,264,60,-3,2,5,4,-55,476,-12,-67,-29,-3,-2,-6,-3,134,471,13,122,57,-3,3,-1,-2
SONATSOFTW,354,321,-24,188,-10,-27,-9,1,1,-5,-2,-3,291,176,24,288,59,1,2,5,6,-83,191,-10,-86,-63,-3,1,-4,-4,140,186,16,137,54,-3,0,-1,4
RATNAMANI,355,319,30,82,4,31,17,2,2,1,4,1,237,85,23,238,57,-3,2,0,0,-45,85,-12,-44,-19,-3,-2,-4,-5,96,86,17,97,34,-3,1,-1,0
SUNDRMFAST,356,318,14,23,14,26,-15,2,2,6,5,12,216,21,18,228,54,-3,0,0,3,76,12,21,88,55,-3,2,0,1,0,27,-13,12,13,-2,1,3,-2
CAPLIPOINT,357,317,-27,317,-10,-33,-17,2,1,-1,-2,-6,279,304,20,273,59,1,2,5,6,-67,318,3,-73,-63,2,-2,-4,-3,138,310,18,132,51,-3,0,-1,4
GRANULES,358,316,-3,411,-5,-13,9,-3,-2,-5,3,-10,267,409,15,257,59,2,2,6,5,-92,414,-14,-102,-63,-3,-2,-7,-3,154,408,16,144,59,-3,2,-1,4
ANGELONE,359,315,18,216,14,15,-1,2,2,0,1,-3,267,210,24,264,59,-3,2,1,6,-51,216,-9,-54,-35,-3,4,-5,-3,84,215,-11,81,56,-3,3,-1,-2
DRREDDY,360,314,-8,156,-7,-11,9,-3,-2,-5,0,-3,267,149,15,264,59,2,2,6,5,-90,160,-11,-93,-63,-3,-2,-6,-5,148,151,13,145,60,-3,2,-1,3
KNRCON,361,313,1,497,6,2,-15,2,2,2,4,1,213,496,11,214,57,-3,0,1,5,32,489,13,33,27,-3,0,-2,-3,66,497,-7,67,39,-3,1,-1,4
HSCL,362,313,-26,350,-9,-35,-15,2,3,-5,-2,-9,279,331,21,270,58,2,2,4,6,-59,348,-10,-68,-35,-3,-2,-5,-4,128,344,16,119,52,-3,0,-1,0
ERIS,363,311,-4,375,3,-4,-15,2,4,2,0,0,234,372,14,234,57,1,2,0,4,5,368,3,5,-9,2,2,4,3,76,374,13,76,30,-3,-2,-3,3
SUNTECK,364,308,39,370,11,34,17,2,2,2,5,-5,234,373,11,229,60,-3,2,4,4,-54,378,-15,-59,-29,-3,-2,-4,-1,94,373,4,89,43,-3,1,1,1
HCLTECH,365,305,-36,477,-13,-49,-11,-3,1,-7,-3,-13,288,464,21,275,60,2,2,7,4,-86,480,-10,-99,-63,-3,-2,-7,-1,152,470,18,139,59,-3,0,-1,3
LATENTVIEW,366,300,93,326,16,102,63,2,2,4,6,9,21,350,11,30,-14,-2,2,5,5,15,336,-12,24,39,-3,-2,-5,-2,162,334,19,171,49,-2,2,7,6
ABFRL,367,297,47,337,19,48,15,2,2,3,6,1,180,344,4,181,49,-3,4,2,4,19,337,-10,20,39,-3,0,-5,-2,50,346,11,51,9,-2,0,4,3
ALOKINDS,368,296,-14,473,-8,-16,-7,2,3,-4,0,-2,219,470,19,217,39,2,2,5,6,-59,475,-11,-61,-35,-3,1,-6,-5,152,466,18,150,59,-3,0,-1,3
TIMKEN,369,295,11,214,13,23,-15,2,2,5,4,12,207,214,18,219,52,-3,0,-1,3,85,199,10,97,61,2,2,6,4,-20,221,-10,-8,-7,-2,4,2,3
ASTRAL,370,294,1,284,-7,-5,15,-3,-2,-3,1,-6,240,279,18,234,60,-3,2,3,0,-71,286,-12,-77,-43,-3,-2,-7,-4,130,279,6,124,60,-2,2,-1,0
MRF,371,289,-34,413,-16,-46,-11,-2,1,-6,0,-12,288,405,21,276,60,2,2,5,6,-91,415,-16,-103,-63,-3,-2,-5,-2,138,410,23,126,53,-3,0,-2,-2
ITI,372,287,-18,63,-10,-23,-15,2,3,-2,4,-5,276,49,19,271,59,2,2,4,6,-56,60,-8,-61,-35,-3,-2,-6,-2,90,53,-12,85,56,-3,3,-3,4
TIINDIA,373,284,-31,445,-8,-38,-11,-3,-2,-4,-3,-7,261,436,23,254,60,-3,2,1,4,-75,446,-10,-82,-63,2,1,-2,-3,136,435,16,129,54,-3,0,-2,3
RKFORGE,374,283,-16,157,-8,-16,-15,2,1,0,4,0,261,152,23,261,59,-3,2,2,4,-52,154,-4,-52,-35,-2,-2,-6,-3,90,153,-10,90,55,-3,3,-3,3
JKPAPER,375,282,-10,472,16,-9,-39,2,2,5,4,1,210,473,16,211,54,-3,0,-1,4,53,459,20,54,35,-3,2,-1,0,28,476,8,29,9,-3,1,-1,0
MASTEK,376,282,-26,190,-8,-32,-17,2,1,-1,-3,-6,249,185,18,243,60,-3,2,0,6,-63,188,-6,-69,-57,-3,1,-1,3,128,187,14,122,51,-3,0,-3,5
SUMICHEM,377,281,50,208,19,64,15,2,2,8,4,14,102,221,-7,116,44,-3,1,1,-2,93,196,24,107,63,-3,2,2,5,22,218,5,36,-1,2,3,5,-3
TATAELXSI,378,279,2,58,-4,-1,3,1,2,-4,4,-3,243,56,18,240,60,-3,2,0,4,-41,59,-12,-44,-15,-3,-2,-5,-4,78,57,10,75,33,-3,1,-3,1
JYOTHYLAB,379,275,-18,61,-8,-21,-15,2,3,-1,1,-3,282,46,24,279,59,2,2,2,5,-66,61,-8,-69,-55,-3,1,-2,1,80,56,-15,77,56,-3,3,-1,0
RTNINDIA,380,268,-25,90,-10,-34,-15,2,1,-5,2,-9,249,84,20,240,59,-3,2,0,5,-67,92,-15,-76,-45,-3,-2,-1,-1,120,85,14,111,51,-3,0,-3,1
GLAXO,381,263,-32,498,-11,-44,-17,2,1,-4,-3,-12,267,495,17,255,59,2,2,3,6,-76,501,3,-88,-63,-3,-2,-7,-4,116,494,13,104,51,-3,0,-4,1
PRAJIND,382,262,35,211,13,25,23,-3,0,-2,4,-10,228,215,16,218,57,-3,2,0,4,-59,219,-10,-69,-35,-3,-2,-6,-3,68,217,-6,58,42,-3,3,-3,1
GRINDWELL,383,261,-1,282,8,3,-25,2,2,6,6,4,210,280,16,214,54,-3,0,-1,4,48,273,-4,52,41,-3,2,7,5,0,281,-6,4,9,-3,1,-1,0
BIOCON,384,256,86,457,8,90,63,2,2,5,6,4,15,479,-6,19,-1,2,3,2,5,67,457,18,71,49,-3,0,-1,4,84,472,17,88,17,-2,2,4,4
HDFCBANK,385,249,37,469,16,49,9,2,2,4,4,12,186,474,11,198,54,-3,1,1,-2,-4,470,-15,8,25,-3,-2,-5,-4,18,475,8,30,-9,2,3,4,1
WIPRO,386,249,-40,351,-15,-55,-11,-3,-2,-6,-3,-15,249,340,12,234,60,2,2,2,5,-87,351,-9,-102,-63,-3,-2,-6,-4,142,342,20,127,53,-3,0,-2,3
SUVENPHAR,387,249,-32,125,-7,-39,-19,-3,-2,-4,3,-7,240,119,18,233,58,-3,2,0,5,-64,126,-10,-71,-61,2,4,1,0,112,121,14,105,44,-3,0,-3,4
JMFINANCIL,388,247,-29,189,-13,-28,-28,2,3,2,5,1,222,187,14,223,53,2,2,-1,4,39,180,19,40,17,-3,2,0,4,14,189,-13,15,24,-3,1,-2,0
DELHIVERY,389,245,81,15,5,84,63,2,2,6,3,3,-69,29,8,-66,-38,-2,3,2,4,86,10,16,89,63,2,2,3,0,144,18,13,147,45,2,2,5,5
HDFCLIFE,390,242,31,372,-3,30,41,-3,0,-4,0,-1,216,374,9,215,59,-2,2,1,3,-68,379,-12,-69,-43,-3,1,-7,-4,64,375,8,63,25,-2,3,-3,1
TMB,391,241,10,120,11,7,-11,2,2,1,5,-3,222,122,13,219,59,-2,2,-1,3,-4,115,-8,-7,15,-3,-2,-4,-2,16,124,-6,13,13,-3,4,2,-2
GAEL,392,240,-17,412,-6,-20,-17,2,1,-1,4,-3,237,411,18,234,57,-3,2,0,5,-87,412,-10,-90,-63,-3,-2,-6,-3,110,411,13,107,44,-3,0,-3,4
HOMEFIRST,393,237,-1,218,-5,-6,5,1,2,-4,0,-5,216,216,10,211,59,-3,2,0,4,-63,218,-16,-68,-35,-3,1,-6,-4,90,214,13,85,33,-2,1,-3,3
FINEORG,394,232,12,154,16,16,-15,2,2,5,2,4,180,156,13,184,52,-3,-2,-3,3,66,140,20,70,49,-3,2,-4,2,-30,157,3,-26,-15,-2,1,2,-4
SWSOLAR,395,231,-4,348,-10,-18,11,2,-2,-5,0,-14,180,346,16,166,30,2,2,5,5,-85,350,-8,-99,-63,-3,-2,-7,-2,154,341,18,140,59,-3,0,-2,5
RENUKA,396,225,0,249,13,1,-25,2,2,4,4,1,189,251,18,190,46,-3,0,-1,3,61,240,19,62,39,-3,2,-1,5,-26,252,5,-25,-19,-3,1,2,1
GICRE,397,223,-28,221,-8,-44,-17,2,1,-4,-2,-16,216,218,19,200,38,2,2,5,6,-89,224,-12,-105,-63,-3,1,-7,-5,140,211,18,124,54,-3,0,-2,3
BALAMINES,398,223,13,215,13,17,-15,2,2,5,6,4,117,219,4,121,32,-3,4,-1,3,75,206,9,79,59,2,2,0,3,14,220,3,18,-1,-3,1,4,3
INDIACEM,399,222,-1,314,13,3,-25,2,2,2,5,4,207,314,14,211,53,-3,2,-1,4,-2,311,13,2,-5,-3,0,-4,-3,14,315,-6,18,15,-3,1,-1,1
PRINCEPIPE,400,220,16,373,18,25,-15,2,2,4,5,9,183,375,14,192,46,-3,0,-1,5,56,362,16,65,47,-3,0,-2,-2,-44,381,-8,-35,-15,-3,1,3,0
AUBANK,401,218,21,470,18,31,-15,2,2,8,6,10,150,475,9,160,45,-3,0,1,-2,81,453,17,91,61,-2,2,3,0,-44,478,-13,-34,-14,-2,4,3,0
COFORGE,402,206,-33,191,-16,-42,-17,2,1,-3,0,-9,240,186,18,231,58,-3,2,0,5,-90,192,-12,-99,-63,-3,-2,-5,-5,98,188,11,89,44,-3,0,-3,0
DEEPAKFERT,403,205,17,343,14,26,-9,2,2,3,5,9,132,347,13,141,38,-3,-2,-3,1,51,334,8,60,47,-3,0,-4,3,-4,348,6,5,-15,-2,4,2,3
ALKEM,404,205,-43,222,-12,-49,-19,-3,-2,-4,-3,-6,273,209,19,267,59,2,2,4,5,-91,222,-13,-97,-63,-3,-2,-6,-4,72,216,-10,66,53,-3,0,-2,-2
KAYNES,405,197,-47,448,-13,-65,-19,-3,-2,-7,-3,-18,285,433,24,267,62,-2,2,3,6,-79,448,-15,-97,-63,2,1,-2,-2,56,439,-10,38,42,-3,0,-4,3
MAPMYINDIA,406,194,0,155,-5,-6,5,2,2,-2,-2,-6,180,157,16,174,38,-2,2,2,4,-46,155,-15,-52,-15,-3,-2,-6,-5,66,154,-7,60,42,-3,1,-3,3
VARROC,407,187,26,408,-3,23,25,2,2,-4,4,-3,60,414,19,57,-14,2,2,6,5,-46,408,-16,-49,-15,-3,-2,-7,-3,150,406,14,147,61,-3,3,-1,1
MPHASIS,408,183,-24,87,-8,-30,-17,2,1,0,-2,-6,216,88,11,210,59,-3,2,-1,4,-67,90,-7,-73,-55,-3,1,-4,1,64,89,-3,58,43,-3,0,-3,-2
TECHM,409,181,-34,93,-10,-43,-19,2,1,-4,-4,-9,216,89,10,207,59,-3,2,-1,5,-86,94,-10,-95,-63,-3,-2,-4,-4,94,87,13,85,43,-3,0,-4,-2
SYRMA,410,174,-38,286,-11,-39,-36,2,4,2,1,-1,243,278,18,242,59,-2,2,0,4,-14,283,4,-15,-31,2,3,5,3,-16,282,-12,-17,14,-3,1,-4,-4
KIMS,411,169,-38,478,-11,-54,-19,2,-2,-6,-2,-16,246,469,19,230,58,-3,2,1,5,-83,479,-10,-99,-63,-3,-2,-6,1,60,474,-10,44,44,-3,0,-4,3
GMMPFAUDLR,412,167,22,406,21,36,-15,2,2,7,5,14,99,413,14,113,24,-3,-2,-1,1,88,393,21,102,61,2,2,1,1,-56,414,-13,-42,-15,-2,4,3,-5
LALPATHLAB,413,160,18,55,16,28,-15,2,2,7,6,10,54,58,-6,64,26,-3,3,-3,1,76,40,17,86,43,2,2,8,4,2,60,-12,12,9,-3,1,3,3
ALLCARGO,414,158,-25,85,7,-27,-39,2,3,-4,6,-2,198,91,14,196,54,-3,2,-1,0,-61,89,-13,-63,-35,-3,1,-6,-5,48,90,4,46,23,-3,0,-3,3
JKLAKSHMI,415,149,-68,352,-12,-84,-43,-3,-2,-5,-3,-16,237,342,18,221,58,-3,2,-1,5,-68,349,-6,-84,-63,2,4,-3,-2,64,347,-7,48,44,-3,0,-5,3
NETWORK18,416,146,-26,220,-11,-32,-18,2,1,-1,1,-6,126,220,18,120,15,1,2,0,6,-66,220,6,-72,-63,-3,1,-5,-2,118,213,16,112,43,-3,0,-3,6
MARICO,417,145,7,437,10,8,-15,2,2,4,4,1,114,442,-4,115,46,-3,0,-1,0,61,430,16,62,41,-3,2,0,5,-38,443,3,-37,-19,-3,1,2,-3
NIACL,418,145,-20,88,-8,-32,-9,2,1,-4,-2,-12,123,94,19,111,6,2,2,6,6,-92,96,-13,-104,-63,-3,-2,-6,-5,146,82,23,134,54,-3,0,-2,1
RHIM,419,140,18,278,16,32,-15,2,2,7,6,14,108,283,-10,122,46,-3,0,-1,4,68,269,16,82,41,-2,2,8,3,-68,284,-13,-54,-18,-3,1,2,-3
3MINDIA,420,136,-56,480,-8,-72,-43,2,-2,-6,1,-16,228,472,18,212,53,1,2,-2,4,-80,478,-9,-96,-63,-3,-2,-6,3,60,473,14,44,30,-3,-2,-5,-4
CERA,421,125,-34,285,16,-39,-59,2,3,0,4,-5,204,282,18,199,53,-3,0,-1,1,-18,284,15,-23,-29,-3,1,-2,0,-22,283,-12,-27,7,-3,1,-4,0
MTARTECH,422,117,2,440,18,3,-27,2,2,2,5,1,177,439,13,178,46,-3,0,-1,4,-17,439,16,-16,-19,-3,-2,-6,-3,-46,444,-10,-45,-10,-3,1,1,-2
PPLPHARMA,423,117,95,39,19,103,63,2,2,3,6,8,-129,61,-13,-121,-37,-2,3,1,5,69,43,23,77,47,-3,0,-2,4,74,55,6,82,25,-3,2,6,1
IEX,424,115,66,361,14,75,35,2,2,8,5,9,-105,381,4,-96,-41,-3,3,4,-2,93,356,21,102,63,2,2,1,4,52,376,5,61,15,-3,2,6,1
DEVYANI,425,113,11,495,11,23,-15,2,2,6,5,12,72,499,-8,84,38,-3,0,-1,-2,62,485,18,74,37,2,2,-1,4,-44,498,-12,-32,-14,-2,4,2,0
PATANJALI,426,113,-59,95,-13,-70,-41,2,1,-6,-2,-11,231,87,18,220,57,-3,2,-1,4,-46,87,13,-57,-61,-3,1,1,3,-2,92,-8,-13,20,-3,-2,-5,-3
AAVAS,427,111,69,176,19,84,35,2,2,6,5,15,0,190,-6,15,0,-3,4,2,3,79,173,24,94,55,-3,0,-1,4,-52,190,10,-37,-44,2,3,6,-3
CENTURYPLY,428,110,-42,414,-8,-48,-41,2,1,-1,5,-6,216,412,16,210,54,-3,2,-1,4,-70,409,-7,-76,-63,2,3,-3,-2,12,413,-11,6,23,-3,1,-4,0
ZFCVINDIA,429,105,-66,160,-7,-76,-43,-3,-2,-6,-5,-10,243,154,20,233,57,-3,2,1,4,-82,158,-10,-92,-63,-3,-2,-6,2,20,156,-7,10,30,-3,-2,-5,-3
SHREECEM,430,99,-23,443,4,-29,-25,1,0,-4,1,-6,180,440,3,174,54,1,2,-1,1,-80,447,-9,-86,-55,-3,-2,-6,-5,28,440,-7,22,23,-3,1,-3,3
INFY,431,97,-58,94,-13,-66,-41,2,4,-6,-4,-8,207,90,13,199,54,-3,2,-1,4,-68,91,-9,-76,-47,-3,0,-5,-4,24,91,-11,16,33,-3,0,-5,-2
AETHER,432,95,13,345,15,17,-15,2,2,5,4,4,84,348,14,88,19,-2,-2,-1,0,70,330,24,74,41,-3,2,2,4,-76,351,-7,-72,-39,2,4,2,0
PAGEIND,433,95,5,26,10,11,-15,2,2,2,4,6,96,27,10,102,30,-3,1,-3,-3,40,21,15,46,29,-3,0,-4,3,-52,28,-10,-46,-15,-2,1,2,-2
BRITANNIA,434,93,-65,223,-8,-76,-43,-3,-2,-6,-3,-11,216,217,18,205,57,-3,2,0,-2,-85,221,-8,-96,-63,-3,-2,-6,-3,38,219,-9,27,43,-3,-2,-5,-5
APTUS,435,93,7,121,8,5,-9,2,3,0,3,-2,6,127,10,4,-19,2,2,4,3,-20,116,4,-22,-27,-2,3,-4,6,102,122,14,100,36,-3,3,1,0
METROBRAND,436,89,-58,128,-3,-65,-43,-3,-2,-4,-3,-7,234,120,21,227,53,-2,2,-1,5,-66,127,-10,-73,-61,2,4,1,-2,-14,126,-8,-21,10,-3,-2,-5,1
CHEMPLASTS,437,88,66,19,13,75,35,2,2,8,6,9,-84,30,3,-75,-44,2,3,4,4,47,18,-12,56,59,-2,2,0,0,50,25,6,59,9,-2,3,6,3
BALRAMCHIN,438,76,-9,84,13,-8,-25,2,2,-2,1,1,162,92,14,163,46,-3,0,-1,-2,-32,83,-15,-31,-9,-3,-2,-4,1,-46,93,-6,-45,-19,-2,4,2,-2
EMAMILTD,439,74,-2,438,10,5,-25,2,2,4,5,7,132,441,11,139,39,-3,0,-3,0,35,433,-5,42,41,-3,2,2,-2,-98,446,-10,-91,-35,-3,1,-1,-1
KAJARIACER,440,64,-55,382,-10,-53,-45,2,2,-1,-3,2,153,377,-3,155,54,-3,0,-1,4,-28,374,-8,-26,-19,-3,1,-3,4,-8,379,-12,-6,7,-3,1,-1,4
EPL,441,64,-47,126,4,-46,-59,2,2,0,4,1,138,124,3,139,39,2,0,-3,5,-28,119,6,-27,-29,-3,1,-4,1,0,125,3,1,7,-3,1,-4,-4
CGCL,442,62,-38,476,13,-40,-59,2,3,-1,4,-2,153,476,13,151,40,-3,0,-3,4,-25,473,12,-27,-29,-3,1,-4,-2,-26,477,-15,-28,3,-3,1,-5,6
NAVINFLUOR,443,62,17,312,14,32,-15,2,2,8,6,15,30,318,-13,45,31,-3,1,-4,-2,98,295,17,113,63,2,2,8,6,-98,319,-15,-83,-39,2,4,2,-3
WHIRLPOOL,444,59,74,329,21,92,35,2,2,8,6,18,-69,352,-8,-51,-13,-2,1,1,-2,78,325,16,96,61,-3,2,1,1,-42,350,18,-24,-46,2,3,6,-4
CCL,445,58,-65,499,-7,-75,-61,2,4,-1,-2,-10,216,497,18,206,54,-3,0,-2,5,-45,499,11,-55,-61,2,2,-1,2,-38,499,-8,-48,3,-3,-2,-6,-3
ADANIENSOL,446,49,35,339,8,39,17,2,2,2,4,4,33,349,-8,37,18,-3,4,0,0,-3,340,-6,1,9,-2,1,-5,0,-20,349,15,-16,-30,-2,2,4,1
AFFLE,447,49,-68,319,-11,-77,-59,2,3,-1,-2,-9,186,316,14,177,48,-3,0,-1,4,-48,316,-6,-57,-29,-3,-2,-5,-3,-12,316,-10,-21,13,-3,1,-3,-4
YESBANK,448,48,42,494,4,43,37,2,2,-4,1,1,-36,500,13,-35,-39,2,2,5,5,-29,497,-8,-28,-9,-3,-2,-5,-2,70,495,20,71,15,-3,0,-1,4
CROMPTON,449,32,41,308,16,51,9,2,2,8,4,10,-24,319,-8,-14,-4,-3,4,2,1,79,299,17,89,43,2,2,9,6,-74,318,3,-64,-45,-2,1,5,1
PGHH,450,28,-63,159,-7,-72,-43,-3,-2,-5,-3,-9,207,155,18,198,53,-3,2,-1,0,-83,159,-7,-92,-63,-3,1,-7,-4,-24,158,-10,-33,9,-3,-2,-4,-2
DALBHARAT,451,22,-62,384,-3,-71,-59,2,1,-5,2,-9,180,376,14,171,47,-3,0,-2,4,-61,380,-10,-70,-35,-3,-2,-6,-5,-26,380,-12,-35,7,-3,1,-4,-2
TV18BRDCST,452,22,-58,30,-11,-67,-41,2,1,-6,-3,-9,117,26,18,108,13,1,2,-1,6,-74,29,-3,-83,-63,-3,1,-4,-2,46,26,-8,37,34,-3,-2,-4,6
ALKYLAMINE,453,22,18,25,18,16,-15,2,2,5,6,-2,15,28,-10,13,20,-3,-2,-4,4,51,20,16,49,35,-3,2,-2,3,-60,29,5,-62,-39,-2,1,2,3
HAPPSTMNDS,454,21,-1,439,13,3,-25,2,2,4,3,4,30,443,-7,34,24,-3,-2,-3,1,70,426,21,74,41,-3,2,6,3,-82,445,4,-78,-43,-3,1,2,-2
LXCHEM,455,19,17,279,16,23,-15,2,2,6,6,6,48,286,10,54,7,-3,-2,1,3,76,268,19,82,43,2,2,6,4,-128,286,-8,-122,-59,-3,1,2,3
RAMCOCEM,456,19,-17,123,14,-14,-35,2,2,0,0,3,105,126,-3,108,40,-3,0,-3,4,-46,122,-4,-43,-29,-3,-2,-5,-3,-26,127,-13,-23,7,-3,1,-2,-3
HONASA,457,5,-13,442,-8,-22,-15,2,3,0,5,-9,-63,446,-9,-72,-5,-2,-2,-2,-1,-36,440,-11,-45,-33,2,4,-1,3,126,437,13,117,46,-2,3,0,3
NYKAA,458,3,98,38,17,116,63,2,2,8,6,18,-201,63,-15,-183,-55,-2,3,1,1,76,37,16,94,59,-3,2,1,1,12,59,9,30,-13,-2,2,7,3
INDIAMART,459,-16,-77,500,-8,-79,-63,-3,1,-1,-3,-2,162,498,10,160,46,-3,0,-3,4,-9,495,10,-11,-25,2,2,2,0,-90,500,-7,-92,-25,-3,-2,-4,-4
IIFL,460,-19,-16,219,18,-18,-48,2,3,4,5,-2,33,222,-18,31,38,-3,0,-3,-3,26,209,23,24,6,-3,0,0,0,-60,222,-16,-62,-12,-3,1,-3,3
ANURAS,461,-35,-83,320,-12,-85,-63,-3,-2,-6,3,-2,165,317,9,163,47,-3,0,-2,4,-73,319,-12,-75,-63,2,3,-1,-2,-42,317,-13,-44,3,-3,-2,-5,-1
SBFC,462,-41,25,434,5,35,9,2,2,6,1,10,-123,448,-10,-113,-29,-2,1,0,-1,77,424,17,87,43,2,2,7,6,-30,442,10,-20,-35,2,1,5,2
PVRINOX,463,-41,14,213,13,23,-15,2,2,7,5,9,-18,223,-4,-9,7,-3,-2,-4,0,72,205,16,81,41,2,2,7,4,-118,223,-15,-109,-43,-3,4,2,-4
VIPIND,464,-48,14,56,16,11,-15,2,2,3,6,-3,21,59,-7,18,24,-3,-2,-5,0,4,56,-7,1,25,-3,-2,-5,-4,-84,62,-6,-87,-43,-2,4,1,4
TTML,465,-58,-74,31,-11,-83,-61,2,1,-5,0,-9,180,23,15,171,46,-3,0,-3,5,-81,31,-12,-90,-55,-3,-2,-6,-3,-74,30,-10,-83,-25,-3,1,-4,4
SBICARD,466,-63,15,342,18,26,-15,2,2,6,2,11,-60,351,-7,-49,-7,-3,1,-1,-3,81,326,24,92,55,-3,0,1,4,-110,352,-11,-99,-53,2,4,3,0
LTIM,467,-65,-80,96,-15,-110,-61,2,4,-6,-4,-30,147,93,10,117,48,-3,0,-4,-2,-66,95,4,-96,-61,-3,-2,-5,1,-36,94,-10,-66,7,-3,-2,-6,-4
IDEA,468,-74,-34,380,-8,-44,-17,-2,1,-5,-3,-10,-33,379,15,-43,-34,2,2,3,1,-9,373,9,-19,-31,2,4,6,1,12,377,16,2,-1,-3,0,-4,-2
STLTECH,469,-74,17,182,17,23,-15,2,2,5,6,6,-75,191,-9,-69,-15,-3,1,-2,3,66,177,19,72,49,-3,0,-2,3,-88,191,3,-82,-53,-2,1,3,4
UPL,470,-119,15,152,15,29,-15,2,2,7,4,14,-84,159,-12,-70,-6,-3,1,-4,-4,74,137,14,88,59,-2,2,1,0,-138,159,-15,-124,-59,2,4,2,-3
ATUL,471,-126,-12,283,16,-3,-39,2,2,6,1,9,-36,287,-10,-27,9,-3,-2,-4,-2,73,267,16,82,43,2,2,4,6,-160,287,-13,-151,-63,-3,1,1,-3
ASIANPAINT,472,-128,-64,256,-10,-65,-59,2,3,0,0,-1,81,253,-3,80,38,-3,-2,-3,0,-56,255,-8,-57,-35,-3,-2,-5,-3,-88,253,-12,-89,-21,-3,1,-5,-4
VAIBHAVGBL,473,-137,-54,288,-13,-63,-42,2,1,-6,4,-9,78,285,10,69,16,-3,2,-3,4,-90,288,-13,-99,-63,-3,1,-7,-5,-62,285,-10,-71,-15,-3,-2,-4,3
JUBLFOOD,474,-141,-40,92,-6,-37,-47,2,3,4,4,3,-15,95,-10,-12,14,-3,-2,-4,0,43,77,15,46,13,2,2,8,3,-132,95,-13,-129,-45,-3,1,-3,-3
BLUEDART,475,-156,-32,444,-7,-35,-33,2,2,4,0,-3,21,444,-8,18,24,-3,-2,-4,0,-4,438,-7,-7,-3,2,3,4,-3,-138,448,-14,-141,-45,-3,1,-4,-4
KRBL,476,-201,-64,479,-8,-69,-59,2,2,-1,0,-5,57,478,-7,52,28,-3,0,-3,4,-55,474,-13,-60,-29,-3,-2,-6,-2,-134,480,-12,-139,-45,-3,1,-5,-3
IBULHSGFIN,477,-211,-47,446,-8,-46,-39,2,2,-4,0,1,-99,447,7,-98,-47,1,2,0,4,-58,443,-8,-57,-35,-3,-2,-6,-4,-8,441,13,-7,-10,-3,1,-3,-2
BATAINDIA,478,-213,-49,254,-11,-40,-49,2,3,3,3,9,-36,254,-7,-27,7,-3,-2,-5,-2,43,243,17,52,11,2,2,6,5,-180,256,-15,-171,-65,-3,1,-4,-4
ATGL,479,-225,-61,64,-6,-70,-53,2,1,-5,0,-9,9,60,-15,0,18,-3,4,-2,1,-88,64,-9,-97,-63,-3,-2,-7,-4,-76,61,16,-85,-48,-3,0,-1,-2
TVSSCS,480,-225,6,57,16,7,-25,2,2,6,5,1,-150,62,16,-149,-59,-2,-2,-2,-1,64,47,15,65,41,-3,2,5,4,-146,63,-10,-145,-63,-2,1,1,0
BERGEPAINT,481,-248,-55,447,10,-55,-63,2,-2,-3,1,0,-15,445,-8,-15,8,-3,-2,-4,4,-78,445,-7,-78,-63,2,-2,-5,-3,-100,447,4,-100,-49,-3,1,-4,1
GLAND,482,-260,-37,379,-10,-42,-17,2,-2,-5,-5,-5,-141,382,4,-146,-60,2,3,0,4,-79,384,-13,-84,-63,-3,1,-2,1,2,378,14,-3,-1,-3,0,-4,-5
HAPPYFORGE,483,-307,-2,83,-3,5,-15,2,2,6,6,7,-237,96,-13,-230,-59,-2,-2,-2,-1,77,71,16,84,43,2,2,8,6,-152,96,-13,-145,-63,-2,1,0,1
AWL,484,-314,-54,381,4,-53,-59,2,3,-4,0,1,-87,380,10,-86,-39,-2,1,-3,4,-56,376,-13,-55,-29,-3,-2,-4,-5,-118,382,8,-117,-70,2,1,0,0
KANSAINER,485,-318,-55,29,-13,-57,-47,2,3,0,0,-2,-81,31,-8,-83,-13,-3,-2,-4,3,-8,26,-8,-10,3,-3,2,-3,1,-172,31,-13,-174,-65,-3,1,-3,-3
MEDPLUS,486,-319,-20,474,-4,-17,-25,-2,2,4,5,3,-198,480,8,-195,-65,-2,-2,-3,-2,34,462,11,37,9,2,2,5,5,-138,479,-10,-135,-63,-2,4,1,1
CLEAN,487,-322,-22,253,8,-26,-39,2,3,4,0,-4,-225,255,-6,-229,-65,-3,1,-3,1,77,237,18,73,43,2,2,6,6,-148,255,-7,-152,-65,-3,1,-1,1
HINDUNILVR,488,-355,-81,415,-16,-93,-63,2,1,-5,0,-12,-18,415,-7,-30,14,-3,-2,-5,-3,-90,413,-11,-102,-63,-3,-2,-6,-5,-154,415,-12,-166,-49,-3,-2,-7,-4
PEL,489,-355,-56,127,-7,-59,-59,2,3,0,5,-3,-105,128,-7,-108,-21,-3,-2,-5,3,-31,120,-8,-34,-15,-3,0,-3,-2,-160,128,-10,-163,-65,-3,1,-4,1
CAMPUS,490,-359,-22,378,4,-21,-39,2,3,5,3,1,-228,383,-11,-227,-59,-2,1,-4,-1,40,365,12,41,17,-2,2,7,4,-150,383,-8,-149,-66,-2,1,0,0
DABUR,491,-381,-95,416,-16,-140,-63,-3,-2,-7,-4,-45,-15,416,-7,-60,14,-3,-2,-5,-2,-84,416,-15,-129,-63,1,1,-6,-2,-142,416,-7,-187,-49,-3,-2,-5,-5
MANYAVAR,492,-385,-72,192,-10,-82,-62,2,1,-1,-2,-10,-93,192,-10,-103,-10,-2,-2,-5,-2,-66,189,-7,-76,-63,2,3,-1,0,-144,192,-13,-154,-45,-3,1,-7,-5
TATATECH,493,-417,-6,59,13,-5,-27,2,2,1,3,1,-234,64,-13,-233,-58,-2,-2,-2,-1,-26,58,-4,-25,-9,-3,-2,-5,-3,-152,64,-13,-151,-63,-2,1,1,0
RAJESHEXPO,494,-426,-60,318,-7,-65,-56,2,3,0,-2,-5,-174,320,-10,-179,-36,-3,1,-6,-4,-29,313,-12,-34,-5,-3,-2,-5,-2,-158,320,-15,-163,-68,2,4,0,-2
INDIGOPNTS,495,-452,-60,287,-8,-62,-55,2,3,0,-2,-2,-210,288,-8,-212,-65,2,1,-1,1,-22,285,4,-24,-29,-3,4,-1,3,-158,288,-6,-160,-65,-3,1,-4,-2
STARHEALTH,496,-495,-58,255,-13,-61,-45,1,2,-4,1,-3,-255,256,-15,-258,-65,-2,1,-1,-3,-31,253,-8,-34,-9,-3,-2,-5,-4,-148,254,-12,-151,-69,2,4,0,1
NUVOCO,497,-519,-64,383,-10,-66,-59,2,3,0,0,-2,-243,384,-10,-245,-66,-3,-2,-3,3,-56,377,-7,-58,-35,-3,-2,-5,-4,-154,384,-6,-156,-65,-3,1,-5,1
ZEEL,498,-564,-58,158,-8,-60,-59,2,3,-1,5,-2,-264,160,-9,-266,-66,-3,-2,-6,-2,-58,157,-10,-60,-35,-3,-2,-6,-2,-182,160,-13,-184,-65,-3,1,-6,-5
RBA,499,-575,-89,32,-10,-105,-63,-3,-2,-6,-5,-16,-204,32,8,-220,-66,-3,-2,-6,1,-88,32,-15,-104,-63,-3,1,-7,-1,-178,32,-10,-194,-69,-3,-2,-6,1
BANDHANBNK,500,-601,-79,501,-16,-85,-62,2,1,-2,-2,-6,-270,501,-9,-276,-68,-3,-2,-6,-2,-76,500,-14,-82,-63,-2,4,-4,3,-170,501,-8,-176,-65,-3,1,-5,-5
PAYTM,501,-628,-75,224,-8,-84,-64,1,1,-5,0,-9,-276,224,-13,-285,-68,-2,-2,-5,-2,-92,223,-14,-101,-63,-3,1,-8,-5,-176,224,-16,-185,-65,-3,4,-6,-2
